id,ci_num,fob_id,pay_account_id,other_pay_id,other_pay_account,charge_org_code,charge_account_num,charge_option,charge_day,charge_base_amt,charge_amt,pay_trans_type,pay_trans_dtime,pay_trans_amt,pay_balance_amt,pay_trans_org_code,pay_trans_id,pay_trans_memo,pay_merchant_name,pay_trans_category,pay_pay_method
0,4444444444444444444444444444444444444444444444444444444444444444444444444444444444444444,bbbbbbbbbbbbbbbbbbbbbbbbbbbbbbbbbbbbbbbbbbbbbbbbbbbbbbbbbbbb1111,pkh95,,,신한,110-42-987654,02,,2000000.0,10000.0,5102,2021-01-01 13: 14:56,10000,2010000,,,***2744 박*훈,,,02
1,4444444444444444444444444444444444444444444444444444444444444444444444444444444444444444,bbbbbbbbbbbbbbbbbbbbbbbbbbbbbbbbbbbbbbbbbbbbbbbbbbbbbbbbbbbb1111,pkh95,qcikp59ewzqd215rbw55zy3ncu7gma0yelbcdcr24ybds7p0ibyhohjhcdfhgpax,rlqhxzio,,,02,,,,5201,2021-01-01 13: 14:56,12000,1998000,국민,110-42-987654,***1974 최*철,,,02
2,4444444444444444444444444444444444444444444444444444444444444444444444444444444444444444,bbbbbbbbbbbbbbbbbbbbbbbbbbbbbbbbbbbbbbbbbbbbbbbbbbbbbbbbbbbb1111,pkh95,,,신한,110-42-987654,02,,2000000.0,20000.0,5102,2021-01-01 13: 59:52,20000,2018000,,,***2744 박*훈,,,02
3,4444444444444444444444444444444444444444444444444444444444444444444444444444444444444444,bbbbbbbbbbbbbbbbbbbbbbbbbbbbbbbbbbbbbbbbbbbbbbbbbbbbbbbbbbbb1111,pkh95,chqenzi0pjr8pcgl55v0gesu5suuiltz6j2l8zs71c05pwior01btjnflhexo8mv,vqhbnmzz,,,02,,,,5201,2021-01-01 13: 59:52,24940,1993060,카카 오뱅 크,110-42-987654,***1350 강*교,,,02
4,4444444444444444444444444444444444444444444444444444444444444444444444444444444444444444,bbbbbbbbbbbbbbbbbbbbbbbbbbbbbbbbbbbbbbbbbbbbbbbbbbbbbbbbbbbb1111,pkh95,z8j0zliqlw8gsy002mh31urxtp08zngy8oqz398n7i2t4c9cnzh3qbrb74fqdtlk,glfdvtee,,,02,,,,5901,2021-01-23 20: 08:33,4000,1997060,,,김명수,,,02
5,4444444444444444444444444444444444444444444444444444444444444444444444444444444444444444,bbbbbbbbbbbbbbbbbbbbbbbbbbbbbbbbbbbbbbbbbbbbbbbbbbbbbbbbbbbb1111,pkh95,1glds0lovd3fv6yl5pifo0yy3t7gj3vm3ukne8pffpzybdr63nxyhlss594g2ez0,gmqthuju,,,02,,,,5901,2021-01-30 21: 01:13,22300,2019360,,,재현,,,02
6,4444444444444444444444444444444444444444444444444444444444444444444444444444444444444444,bbbbbbbbbbbbbbbbbbbbbbbbbbbbbbbbbbbbbbbbbbbbbbbbbbbbbbbbbbbb1111,pkh95,xh4nc6w4y40ngdqnkqvuqq8h5ks1ajsfulajifz2rjpgklgt5xdf82qhofwy9n9g,idgonbwr,,,02,,,,5901,2021-01-30 22: 44:02,22222,2041582,,,신우형,,,02
7,4444444444444444444444444444444444444444444444444444444444444444444444444444444444444444,bbbbbbbbbbbbbbbbbbbbbbbbbbbbbbbbbbbbbbbbbbbbbbbbbbbbbbbbbbbb1111,pkh95,,,,,02,,,,nan,2021-02-01 14: 56:53,49486,1992096,"카카 오페 이증
권",110-42-987654,***3499 업그레이드(계 좌로 페이머니 이관),,,02
8,4444444444444444444444444444444444444444444444444444444444444444444444444444444444444444,bbbbbbbbbbbbbbbbbbbbbbbbbbbbbbbbbbbbbbbbbbbbbbbbbbbbbbbbbbbb1111,pkh95,,,,,02,,,,5901,2021-02-01 14: 56:53,49486,2041582,"카카 오페 이증
권",110-42-987654,***3499 업그레이드(페 이머니 계좌 입금),,,02
9,4444444444444444444444444444444444444444444444444444444444444444444444444444444444444444,bbbbbbbbbbbbbbbbbbbbbbbbbbbbbbbbbbbbbbbbbbbbbbbbbbbbbbbbbbbb1111,pkh95,,,,,02,,,,5901,2021-02-08 05:14:02,4,2041586,,,,,,02
10,4444444444444444444444444444444444444444444444444444444444444444444444444444444444444444,bbbbbbbbbbbbbbbbbbbbbbbbbbbbbbbbbbbbbbbbbbbbbbbbbbbbbbbbbbbb1111,pkh95,,,,,02,,,,5901,2021-02-15 05: 22:49,5,2041591,,,,,,02
11,4444444444444444444444444444444444444444444444444444444444444444444444444444444444444444,bbbbbbbbbbbbbbbbbbbbbbbbbbbbbbbbbbbbbbbbbbbbbbbbbbbbbbbbbbbb1111,pkh95,,,,,02,,,,5901,2021-02-22 05: 28:53,5,2041596,,,,,,02
12,4444444444444444444444444444444444444444444444444444444444444444444444444444444444444444,bbbbbbbbbbbbbbbbbbbbbbbbbbbbbbbbbbbbbbbbbbbbbbbbbbbbbbbbbbbb1111,pkh95,,,,,02,,,,5901,2021-03-01 05: 25:02,5,2041601,,,,,,02
13,4444444444444444444444444444444444444444444444444444444444444444444444444444444444444444,bbbbbbbbbbbbbbbbbbbbbbbbbbbbbbbbbbbbbbbbbbbbbbbbbbbbbbbbbbbb1111,pkh95,8npvpf2wdqakx4sfio2ounof7v9w7a9brgg8sq3i68rfjkqyywegualn5rhkc8to,sakyfyse,,,02,,,,5202,2021-03-01 14: 32:37,1901,2039700,,,명쑤,,,02
14,4444444444444444444444444444444444444444444444444444444444444444444444444444444444444444,bbbbbbbbbbbbbbbbbbbbbbbbbbbbbbbbbbbbbbbbbbbbbbbbbbbbbbbbbbbb1111,pkh95,,,신한,110-42-987654,02,,2000000.0,20000.0,5102,2021-03-01 14: 33:06,20000,2059700,,,***2744 박*훈,,,02
15,4444444444444444444444444444444444444444444444444444444444444444444444444444444444444444,bbbbbbbbbbbbbbbbbbbbbbbbbbbbbbbbbbbbbbbbbbbbbbbbbbbbbbbbbbbb1111,pkh95,wwrrk02pkqaw54hqxkadgibwahn2r4dcte9jx5clcwbf0gnfjfw0h4gu0be3x75s,tdrdmjla,,,02,,,,5202,2021-03-01 14: 33:06,59600,2000100,,,신효식,,,02
16,4444444444444444444444444444444444444444444444444444444444444444444444444444444444444444,bbbbbbbbbbbbbbbbbbbbbbbbbbbbbbbbbbbbbbbbbbbbbbbbbbbbbbbbbbbb1111,pkh95,,,,,02,,,,5901,2021-03-08 05:31:22,1,2000101,,,,,,02
17,4444444444444444444444444444444444444444444444444444444444444444444444444444444444444444,bbbbbbbbbbbbbbbbbbbbbbbbbbbbbbbbbbbbbbbbbbbbbbbbbbbbbbbbbbbb1111,pkh95,v6i52ae1lztidujw9fv6t0uupyvunothzgrp1rfiqsdiocyhlve9s94w5xequeoa,wvdkqrvc,,,02,,,,5901,2021-03-09 22: 12:43,5000,2005101,,,송병학,,,02
18,4444444444444444444444444444444444444444444444444444444444444444444444444444444444444444,bbbbbbbbbbbbbbbbbbbbbbbbbbbbbbbbbbbbbbbbbbbbbbbbbbbbbbbbbbbb1111,pkh95,1glds0lovd3fv6yl5pifo0yy3t7gj3vm3ukne8pffpzybdr63nxyhlss594g2ez0,gmqthuju,,,02,,,,5901,2021-03-27 23: 28:18,20000,2025101,,,재현,,,02
19,4444444444444444444444444444444444444444444444444444444444444444444444444444444444444444,bbbbbbbbbbbbbbbbbbbbbbbbbbbbbbbbbbbbbbbbbbbbbbbbbbbbbbbbbbbb1111,pkh95,xh4nc6w4y40ngdqnkqvuqq8h5ks1ajsfulajifz2rjpgklgt5xdf82qhofwy9n9g,idgonbwr,,,02,,,,5901,2021-03-27 23: 30:33,19999,2045100,,,신우형,,,02
20,4444444444444444444444444444444444444444444444444444444444444444444444444444444444444444,bbbbbbbbbbbbbbbbbbbbbbbbbbbbbbbbbbbbbbbbbbbbbbbbbbbbbbbbbbbb1111,pkh95,,,,,02,,,,5901,2021-03-29 05: 36:47,1,2045101,,,,,,02
21,4444444444444444444444444444444444444444444444444444444444444444444444444444444444444444,bbbbbbbbbbbbbbbbbbbbbbbbbbbbbbbbbbbbbbbbbbbbbbbbbbbbbbbbbbbb1111,pkh95,qlixj5sheedfyu0urfhe8bbsuw3kteyqlq084yrv6tbscdqt1x21mtf5mbrp47kx,uszwzfqp,,,02,,,,5202,2021-03-30 12: 40:58,10450,2034651,,,최승언,,,02
22,4444444444444444444444444444444444444444444444444444444444444444444444444444444444444444,bbbbbbbbbbbbbbbbbbbbbbbbbbbbbbbbbbbbbbbbbbbbbbbbbbbbbbbbbbbb1111,pkh95,,,,,02,,,,5901,2021-04-05 05:40:51,4,2034655,,,,,,02
23,4444444444444444444444444444444444444444444444444444444444444444444444444444444444444444,bbbbbbbbbbbbbbbbbbbbbbbbbbbbbbbbbbbbbbbbbbbbbbbbbbbbbbbbbbbb1111,pkh95,m1erp44mprz3b4jpinf985vivkdwtpyo63pzejviyyktnluyqb1tmdwn321d5ifp,rgnsabya,,,02,,,,5201,2021-04-05 10: 14:00,15400,2019255,하나,110-42-987654,***5407 손*진,,,02
24,4444444444444444444444444444444444444444444444444444444444444444444444444444444444444444,bbbbbbbbbbbbbbbbbbbbbbbbbbbbbbbbbbbbbbbbbbbbbbbbbbbbbbbbbbbb1111,pkh95,suyc8xp0r5uyzy0l12q95iklvcdv99eneis5o6fu6kef23f0ozkchn53fn1q4yr7,qjwbolst,,,02,,,,5901,2021-04-09 16: 05:16,16000,2035255,,,이병훈,,,02
25,4444444444444444444444444444444444444444444444444444444444444444444444444444444444444444,bbbbbbbbbbbbbbbbbbbbbbbbbbbbbbbbbbbbbbbbbbbbbbbbbbbbbbbbbbbb1111,pkh95,suyc8xp0r5uyzy0l12q95iklvcdv99eneis5o6fu6kef23f0ozkchn53fn1q4yr7,qjwbolst,,,02,,,,5202,2021-04-10 01: 56:43,16000,2019255,,,이병훈,,,02
26,4444444444444444444444444444444444444444444444444444444444444444444444444444444444444444,bbbbbbbbbbbbbbbbbbbbbbbbbbbbbbbbbbbbbbbbbbbbbbbbbbbbbbbbbbbb1111,pkh95,z8j0zliqlw8gsy002mh31urxtp08zngy8oqz398n7i2t4c9cnzh3qbrb74fqdtlk,glfdvtee,,,02,,,,5901,2021-04-11 21: 06:52,16000,2035255,,,김명수,,,02
27,4444444444444444444444444444444444444444444444444444444444444444444444444444444444444444,bbbbbbbbbbbbbbbbbbbbbbbbbbbbbbbbbbbbbbbbbbbbbbbbbbbbbbbbbbbb1111,pkh95,,,,,02,,,,5901,2021-04-12 05: 35:53,2,2035257,,,,,,02
28,4444444444444444444444444444444444444444444444444444444444444444444444444444444444444444,bbbbbbbbbbbbbbbbbbbbbbbbbbbbbbbbbbbbbbbbbbbbbbbbbbbbbbbbbbbb1111,pkh95,,,,,02,,,,5501,2021-04-13 13: 21:12,2200,2033057,,,몬스터)울트라에너지 355ML,,A1,02
29,4444444444444444444444444444444444444444444444444444444444444444444444444444444444444444,bbbbbbbbbbbbbbbbbbbbbbbbbbbbbbbbbbbbbbbbbbbbbbbbbbbbbbbbbbbb1111,pkh95,m1erp44mprz3b4jpinf985vivkdwtpyo63pzejviyyktnluyqb1tmdwn321d5ifp,rgnsabya,,,02,,,,5201,2021-04-15 09: 49:00,11350,2021707,하나,110-42-987654,***5407 손*진,,,02
30,4444444444444444444444444444444444444444444444444444444444444444444444444444444444444444,bbbbbbbbbbbbbbbbbbbbbbbbbbbbbbbbbbbbbbbbbbbbbbbbbbbbbbbbbbbb1111,pkh95,oknd5gpq8pds4tfgldrtgzycwrwossvspwogumwdz84cr3yutnpes956f33obriy,vyucokso,,,02,,,,5201,2021-04-18 11: 44:03,6600,2015107,우리,110-42-987654,***3006 공*림,,,02
31,4444444444444444444444444444444444444444444444444444444444444444444444444444444444444444,bbbbbbbbbbbbbbbbbbbbbbbbbbbbbbbbbbbbbbbbbbbbbbbbbbbbbbbbbbbb1111,pkh95,,,,,02,,,,5501,2021-04-18 12: 14:18,6450,2008657,,,등심돈까스 참치마요,,Z1,02
32,4444444444444444444444444444444444444444444444444444444444444444444444444444444444444444,bbbbbbbbbbbbbbbbbbbbbbbbbbbbbbbbbbbbbbbbbbbbbbbbbbbbbbbbbbbb1111,pkh95,,,,,02,,,,5901,2021-04-19 05: 41:57,3,2008660,,,,,,02
33,4444444444444444444444444444444444444444444444444444444444444444444444444444444444444444,bbbbbbbbbbbbbbbbbbbbbbbbbbbbbbbbbbbbbbbbbbbbbbbbbbbbbbbbbbbb1111,pkh95,,,신한,110-42-987654,02,,2000000.0,10000.0,5102,2021-04-19 11: 00:07,10000,2018660,,,***2744 박*훈,,,02
34,4444444444444444444444444444444444444444444444444444444444444444444444444444444444444444,bbbbbbbbbbbbbbbbbbbbbbbbbbbbbbbbbbbbbbbbbbbbbbbbbbbbbbbbbbbb1111,pkh95,m1erp44mprz3b4jpinf985vivkdwtpyo63pzejviyyktnluyqb1tmdwn321d5ifp,rgnsabya,,,02,,,,5201,2021-04-19 11: 00:07,15820,2002840,하나,110-42-987654,***5407 손*진,,,02
35,4444444444444444444444444444444444444444444444444444444444444444444444444444444444444444,bbbbbbbbbbbbbbbbbbbbbbbbbbbbbbbbbbbbbbbbbbbbbbbbbbbbbbbbbbbb1111,pkh95,,,,,02,,,,5501,2021-04-20 08:21:42,500,2002340,,,추가 요금 수단 변경,,L1,02
36,4444444444444444444444444444444444444444444444444444444444444444444444444444444444444444,bbbbbbbbbbbbbbbbbbbbbbbbbbbbbbbbbbbbbbbbbbbbbbbbbbbbbbbbbbbb1111,pkh95,,,,,02,,,,5502,2021-04-20 08:21:42,500,2002840,,,추가 요금 수단 변경,,L1,02
37,4444444444444444444444444444444444444444444444444444444444444444444444444444444444444444,bbbbbbbbbbbbbbbbbbbbbbbbbbbbbbbbbbbbbbbbbbbbbbbbbbbbbbbbbbbb1111,pkh95,,,,,02,,,,5501,2021-04-20 08:22:53,1000,2001840,,,추가 요금 수단 변경,,L1,02
38,4444444444444444444444444444444444444444444444444444444444444444444444444444444444444444,bbbbbbbbbbbbbbbbbbbbbbbbbbbbbbbbbbbbbbbbbbbbbbbbbbbbbbbbbbbb1111,pkh95,,,,,02,,,,5501,2021-04-22 17: 58:11,1000,2000840,,,추가 요금 수단 변경,,L1,02
39,4444444444444444444444444444444444444444444444444444444444444444444444444444444444444444,bbbbbbbbbbbbbbbbbbbbbbbbbbbbbbbbbbbbbbbbbbbbbbbbbbbbbbbbbbbb1111,pkh95,,,신한,110-42-987654,02,,2000000.0,10000.0,5102,2021-04-24 12: 22:34,10000,2010840,,,***2744 박*훈,,,02
40,4444444444444444444444444444444444444444444444444444444444444444444444444444444444444444,bbbbbbbbbbbbbbbbbbbbbbbbbbbbbbbbbbbbbbbbbbbbbbbbbbbbbbbbbbbb1111,pkh95,,,,,02,,,,5501,2021-04-24 12: 22:34,8200,2002640,,,(리쀼약속)(따블...,,A1,02
41,4444444444444444444444444444444444444444444444444444444444444444444444444444444444444444,bbbbbbbbbbbbbbbbbbbbbbbbbbbbbbbbbbbbbbbbbbbbbbbbbbbbbbbbbbbb1111,pkh95,,,신한,110-42-987654,02,,2000000.0,10000.0,5102,2021-04-26 00:17:52,10000,2012640,,,***2744 박*훈,,,02
42,4444444444444444444444444444444444444444444444444444444444444444444444444444444444444444,bbbbbbbbbbbbbbbbbbbbbbbbbbbbbbbbbbbbbbbbbbbbbbbbbbbbbbbbbbbb1111,pkh95,m1erp44mprz3b4jpinf985vivkdwtpyo63pzejviyyktnluyqb1tmdwn321d5ifp,rgnsabya,,,02,,,,5201,2021-04-26 00:17:52,4060,2008580,하나,110-42-987654,***5407 손*진,,,02
43,4444444444444444444444444444444444444444444444444444444444444444444444444444444444444444,bbbbbbbbbbbbbbbbbbbbbbbbbbbbbbbbbbbbbbbbbbbbbbbbbbbbbbbbbbbb1111,pkh95,xh4nc6w4y40ngdqnkqvuqq8h5ks1ajsfulajifz2rjpgklgt5xdf82qhofwy9n9g,idgonbwr,,,02,,,,5901,2021-04-30 22: 51:49,26000,2034580,,,신우형,,,02
44,4444444444444444444444444444444444444444444444444444444444444444444444444444444444444444,bbbbbbbbbbbbbbbbbbbbbbbbbbbbbbbbbbbbbbbbbbbbbbbbbbbbbbbbbbbb1111,pkh95,5di6pqh54buzlzgw7k95iejawzk3svkfd0eo4czwfro03n31vants8265dmj4obe,pzkvbcld,,,02,,,,5901,2021-04-30 22: 54:07,24000,2058580,,,이제영,,,02
45,4444444444444444444444444444444444444444444444444444444444444444444444444444444444444444,bbbbbbbbbbbbbbbbbbbbbbbbbbbbbbbbbbbbbbbbbbbbbbbbbbbbbbbbbbbb1111,pkh95,v6i52ae1lztidujw9fv6t0uupyvunothzgrp1rfiqsdiocyhlve9s94w5xequeoa,wvdkqrvc,,,02,,,,5901,2021-05-01 09: 21:50,24000,2082580,,,송병학,,,02
46,4444444444444444444444444444444444444444444444444444444444444444444444444444444444444444,bbbbbbbbbbbbbbbbbbbbbbbbbbbbbbbbbbbbbbbbbbbbbbbbbbbbbbbbbbbb1111,pkh95,,,,,02,,,,5901,2021-05-03 05: 45:28,2,2082582,,,,,,02
47,4444444444444444444444444444444444444444444444444444444444444444444444444444444444444444,bbbbbbbbbbbbbbbbbbbbbbbbbbbbbbbbbbbbbbbbbbbbbbbbbbbbbbbbbbbb1111,pkh95,,,,,02,,,,5501,2021-05-03 16: 00:14,1000,2081582,,,추가 요금 수단 변경,,L1,02
48,4444444444444444444444444444444444444444444444444444444444444444444444444444444444444444,bbbbbbbbbbbbbbbbbbbbbbbbbbbbbbbbbbbbbbbbbbbbbbbbbbbbbbbbbbbb1111,pkh95,,,,,02,,,,5501,2021-05-03 17: 08:03,200,2081382,,,추가 요금 수단 변경,,L1,02
49,4444444444444444444444444444444444444444444444444444444444444444444444444444444444444444,bbbbbbbbbbbbbbbbbbbbbbbbbbbbbbbbbbbbbbbbbbbbbbbbbbbbbbbbbbbb1111,pkh95,xh4nc6w4y40ngdqnkqvuqq8h5ks1ajsfulajifz2rjpgklgt5xdf82qhofwy9n9g,idgonbwr,,,02,,,,5901,2021-05-05 00:01:45,15000,2096382,,,신우형,,,02
50,4444444444444444444444444444444444444444444444444444444444444444444444444444444444444444,bbbbbbbbbbbbbbbbbbbbbbbbbbbbbbbbbbbbbbbbbbbbbbbbbbbbbbbbbbbb1111,pkh95,1glds0lovd3fv6yl5pifo0yy3t7gj3vm3ukne8pffpzybdr63nxyhlss594g2ez0,gmqthuju,,,02,,,,5901,2021-05-05 00:31:52,16000,2112382,,,재현,,,02
51,4444444444444444444444444444444444444444444444444444444444444444444444444444444444444444,bbbbbbbbbbbbbbbbbbbbbbbbbbbbbbbbbbbbbbbbbbbbbbbbbbbbbbbbbbbb1111,pkh95,rgqaiqim8uwo6wnmcy0wc4mjyx727ugfs42jqyujytn2g1q5894jytqaiupaelfa,ydihveac,,,02,,,,5201,2021-05-05 11: 31:13,10000,2102382,카카 오뱅 크,110-42-987654,***7787 김*운,,,02
52,4444444444444444444444444444444444444444444444444444444444444444444444444444444444444444,bbbbbbbbbbbbbbbbbbbbbbbbbbbbbbbbbbbbbbbbbbbbbbbbbbbbbbbbbbbb1111,pkh95,quyuoq0l3dvwoa9jo5saw74p58joygygwpabybskbxuhd0od2wia7rnvkuslhhwp,duhvchmo,,,02,,,,5202,2021-05-06 08:54:24,3750,2098632,,,현진,,,02
53,4444444444444444444444444444444444444444444444444444444444444444444444444444444444444444,bbbbbbbbbbbbbbbbbbbbbbbbbbbbbbbbbbbbbbbbbbbbbbbbbbbbbbbbbbbb1111,pkh95,,,,,02,,,,5901,2021-05-17 05: 51:58,11,2098643,,,,,,02
54,4444444444444444444444444444444444444444444444444444444444444444444444444444444444444444,bbbbbbbbbbbbbbbbbbbbbbbbbbbbbbbbbbbbbbbbbbbbbbbbbbbbbbbbbbbb1111,pkh95,xh4nc6w4y40ngdqnkqvuqq8h5ks1ajsfulajifz2rjpgklgt5xdf82qhofwy9n9g,idgonbwr,,,02,,,,5901,2021-05-20 00:14:29,23232,2121875,,,신우형,,,02
55,4444444444444444444444444444444444444444444444444444444444444444444444444444444444444444,bbbbbbbbbbbbbbbbbbbbbbbbbbbbbbbbbbbbbbbbbbbbbbbbbbbbbbbbbbbb1111,pkh95,1glds0lovd3fv6yl5pifo0yy3t7gj3vm3ukne8pffpzybdr63nxyhlss594g2ez0,gmqthuju,,,02,,,,5901,2021-05-20 00:18:41,23000,2144875,,,재현,,,02
56,4444444444444444444444444444444444444444444444444444444444444444444444444444444444444444,bbbbbbbbbbbbbbbbbbbbbbbbbbbbbbbbbbbbbbbbbbbbbbbbbbbbbbbbbbbb1111,pkh95,1glds0lovd3fv6yl5pifo0yy3t7gj3vm3ukne8pffpzybdr63nxyhlss594g2ez0,gmqthuju,,,02,,,,5901,2021-05-20 17: 07:41,33000,2177875,,,재현,,,02
57,4444444444444444444444444444444444444444444444444444444444444444444444444444444444444444,bbbbbbbbbbbbbbbbbbbbbbbbbbbbbbbbbbbbbbbbbbbbbbbbbbbbbbbbbbbb1111,pkh95,yvrwwai0jvic1ef5oypdu8h8vewjvudjzjnog9zsj1eb9hah3egq1db8rx075rv5,lckbwlin,,,02,,,,5901,2021-05-21 20: 19:00,10000,2187875,,,준영,,,02
58,4444444444444444444444444444444444444444444444444444444444444444444444444444444444444444,bbbbbbbbbbbbbbbbbbbbbbbbbbbbbbbbbbbbbbbbbbbbbbbbbbbbbbbbbbbb1111,pkh95,,,,,02,,,,5901,2021-05-24 05: 49:13,15,2187890,,,,,,02
59,4444444444444444444444444444444444444444444444444444444444444444444444444444444444444444,bbbbbbbbbbbbbbbbbbbbbbbbbbbbbbbbbbbbbbbbbbbbbbbbbbbbbbbbbbbb1111,pkh95,,,,,02,,,,5501,2021-05-28 14: 20:11,2000,2185890,,,이모티콘샵,,C1,02
60,4444444444444444444444444444444444444444444444444444444444444444444444444444444444444444,bbbbbbbbbbbbbbbbbbbbbbbbbbbbbbbbbbbbbbbbbbbbbbbbbbbbbbbbbbbb1111,pkh95,1glds0lovd3fv6yl5pifo0yy3t7gj3vm3ukne8pffpzybdr63nxyhlss594g2ez0,gmqthuju,,,02,,,,5901,2021-05-28 23: 02:11,21000,2206890,,,재현,,,02
61,4444444444444444444444444444444444444444444444444444444444444444444444444444444444444444,bbbbbbbbbbbbbbbbbbbbbbbbbbbbbbbbbbbbbbbbbbbbbbbbbbbbbbbbbbbb1111,pkh95,,,,,02,,,,5501,2021-05-30 13: 52:16,1000,2205890,,,추가 요금 수단 변경,,L1,02
62,4444444444444444444444444444444444444444444444444444444444444444444444444444444444444444,bbbbbbbbbbbbbbbbbbbbbbbbbbbbbbbbbbbbbbbbbbbbbbbbbbbbbbbbbbbb1111,pkh95,,,,,02,,,,5501,2021-05-30 15: 12:11,800,2205090,,,따릉이 초과 요금,,H1,02
63,4444444444444444444444444444444444444444444444444444444444444444444444444444444444444444,bbbbbbbbbbbbbbbbbbbbbbbbbbbbbbbbbbbbbbbbbbbbbbbbbbbbbbbbbbbb1111,pkh95,,,,,02,,,,5501,2021-05-30 15: 12:45,800,2204290,,,추가요금 결제,,I1,02
64,4444444444444444444444444444444444444444444444444444444444444444444444444444444444444444,bbbbbbbbbbbbbbbbbbbbbbbbbbbbbbbbbbbbbbbbbbbbbbbbbbbbbbbbbbbb1111,pkh95,,,,,02,,,,5901,2021-05-30 19: 36:47,49200,2253490,,,박민,,,02
65,4444444444444444444444444444444444444444444444444444444444444444444444444444444444444444,bbbbbbbbbbbbbbbbbbbbbbbbbbbbbbbbbbbbbbbbbbbbbbbbbbbbbbbbbbbb1111,pkh95,,,,,02,,,,5901,2021-05-31 05: 50:12,22,2253512,,,,,,02
66,4444444444444444444444444444444444444444444444444444444444444444444444444444444444444444,bbbbbbbbbbbbbbbbbbbbbbbbbbbbbbbbbbbbbbbbbbbbbbbbbbbbbbbbbbbb1111,pkh95,v6i52ae1lztidujw9fv6t0uupyvunothzgrp1rfiqsdiocyhlve9s94w5xequeoa,wvdkqrvc,,,02,,,,5901,2021-06-04 15: 11:49,33000,2286512,,,송병학,,,02
67,4444444444444444444444444444444444444444444444444444444444444444444444444444444444444444,bbbbbbbbbbbbbbbbbbbbbbbbbbbbbbbbbbbbbbbbbbbbbbbbbbbbbbbbbbbb1111,pkh95,,,,,02,,,,nan,2021-06-04 20:12:21,11300,2275212,,,ATM 출금,,,02
68,4444444444444444444444444444444444444444444444444444444444444444444444444444444444444444,bbbbbbbbbbbbbbbbbbbbbbbbbbbbbbbbbbbbbbbbbbbbbbbbbbbbbbbbbbbb1111,pkh95,4ten04o95k9ot1fyitn4al8m161g2rey1ss4f4l4bwfscj8jl7wb5t0ubsh9b3mv,cfcayxwe,,,02,,,,5202,2021-06-04 21: 12:03,15151,2260061,,,윤재현,,,02
69,4444444444444444444444444444444444444444444444444444444444444444444444444444444444444444,bbbbbbbbbbbbbbbbbbbbbbbbbbbbbbbbbbbbbbbbbbbbbbbbbbbbbbbbbbbb1111,pkh95,,,,,02,,,,5901,2021-06-07 05:54:08,29,2260090,,,,,,02
70,4444444444444444444444444444444444444444444444444444444444444444444444444444444444444444,bbbbbbbbbbbbbbbbbbbbbbbbbbbbbbbbbbbbbbbbbbbbbbbbbbbbbbbbbbbb1111,pkh95,,,,,02,,,,5501,2021-06-08 12: 52:41,6100,2253990,,,민트 초콜릿 칩 블렌디 드 T,,A1,02
71,4444444444444444444444444444444444444444444444444444444444444444444444444444444444444444,bbbbbbbbbbbbbbbbbbbbbbbbbbbbbbbbbbbbbbbbbbbbbbbbbbbbbbbbbbbb1111,pkh95,,,,,02,,,,5501,2021-06-10 00:18:21,34000,2219990,,,"고추바사삭+시카고 피
자+콜라1.25",,A1,02
72,4444444444444444444444444444444444444444444444444444444444444444444444444444444444444444,bbbbbbbbbbbbbbbbbbbbbbbbbbbbbbbbbbbbbbbbbbbbbbbbbbbbbbbbbbbb1111,pkh95,qlixj5sheedfyu0urfhe8bbsuw3kteyqlq084yrv6tbscdqt1x21mtf5mbrp47kx,uszwzfqp,,,02,,,,5202,2021-06-11 13: 24:37,19000,2200990,,,최승언,,,02
73,4444444444444444444444444444444444444444444444444444444444444444444444444444444444444444,bbbbbbbbbbbbbbbbbbbbbbbbbbbbbbbbbbbbbbbbbbbbbbbbbbbbbbbbbbbb1111,pkh95,,,,,02,,,,5901,2021-06-14 05: 48:28,27,2201017,,,,,,02
74,4444444444444444444444444444444444444444444444444444444444444444444444444444444444444444,bbbbbbbbbbbbbbbbbbbbbbbbbbbbbbbbbbbbbbbbbbbbbbbbbbbbbbbbbbbb1111,pkh95,4tbz2kmng8nsm2plbmj5tw5055ttyn5gindkgui2q19ybbz0bl6m2bglhfm60avy,ngysofjr,,,02,,,,5201,2021-06-19 22: 28:19,25000,2176017,우리,110-42-987654,***0686 이*훈,,,02
75,4444444444444444444444444444444444444444444444444444444444444444444444444444444444444444,bbbbbbbbbbbbbbbbbbbbbbbbbbbbbbbbbbbbbbbbbbbbbbbbbbbbbbbbbbbb1111,pkh95,,,,,02,,,,5901,2021-06-21 05: 48:08,22,2176039,,,,,,02
76,4444444444444444444444444444444444444444444444444444444444444444444444444444444444444444,bbbbbbbbbbbbbbbbbbbbbbbbbbbbbbbbbbbbbbbbbbbbbbbbbbbbbbbbbbbb1111,pkh95,,,,,02,,,,5501,2021-06-22 09:33:37,13500,2162539,,,[각인서비스] '하나뿐인 선물' 커스텀 섬유향수 8ml,,D1,02
77,4444444444444444444444444444444444444444444444444444444444444444444444444444444444444444,bbbbbbbbbbbbbbbbbbbbbbbbbbbbbbbbbbbbbbbbbbbbbbbbbbbbbbbbbbbb1111,pkh95,,,,,02,,,,5901,2021-06-28 05: 50:55,19,2162558,,,,,,02
78,4444444444444444444444444444444444444444444444444444444444444444444444444444444444444444,bbbbbbbbbbbbbbbbbbbbbbbbbbbbbbbbbbbbbbbbbbbbbbbbbbbbbbbbbbbb1111,pkh95,8npvpf2wdqakx4sfio2ounof7v9w7a9brgg8sq3i68rfjkqyywegualn5rhkc8to,sakyfyse,,,02,,,,5202,2021-07-03 17: 53:04,28004,2134554,,,명쑤,,,02
79,4444444444444444444444444444444444444444444444444444444444444444444444444444444444444444,bbbbbbbbbbbbbbbbbbbbbbbbbbbbbbbbbbbbbbbbbbbbbbbbbbbbbbbbbbbb1111,pkh95,suyc8xp0r5uyzy0l12q95iklvcdv99eneis5o6fu6kef23f0ozkchn53fn1q4yr7,qjwbolst,,,02,,,,5202,2021-07-04 12: 37:23,6001,2128553,,,이병훈,,,02
80,4444444444444444444444444444444444444444444444444444444444444444444444444444444444444444,bbbbbbbbbbbbbbbbbbbbbbbbbbbbbbbbbbbbbbbbbbbbbbbbbbbbbbbbbbbb1111,pkh95,,,,,02,,,,5901,2021-07-05 05: 58:00,18,2128571,,,,,,02
81,4444444444444444444444444444444444444444444444444444444444444444444444444444444444444444,bbbbbbbbbbbbbbbbbbbbbbbbbbbbbbbbbbbbbbbbbbbbbbbbbbbbbbbbbbbb1111,pkh95,,,,,02,,,,5501,2021-07-05 19: 50:08,5600,2122971,,,[블론드] 아이스 스타벅 스 돌체 라떼,,J1,02
82,4444444444444444444444444444444444444444444444444444444444444444444444444444444444444444,bbbbbbbbbbbbbbbbbbbbbbbbbbbbbbbbbbbbbbbbbbbbbbbbbbbbbbbbbbbb1111,pkh95,qlixj5sheedfyu0urfhe8bbsuw3kteyqlq084yrv6tbscdqt1x21mtf5mbrp47kx,uszwzfqp,,,02,,,,5202,2021-07-07 13: 52:55,7000,2115971,,,최승언,,,02
83,4444444444444444444444444444444444444444444444444444444444444444444444444444444444444444,bbbbbbbbbbbbbbbbbbbbbbbbbbbbbbbbbbbbbbbbbbbbbbbbbbbbbbbbbbbb1111,pkh95,e12qxtiuywt1cun9q6cszdtruvgqbmqvncdrjnr7cvs0mapghrgrepqofmtowfbd,nzgonnaj,,,02,,,,5202,2021-07-10 15: 26:46,19000,2096971,,,김동주,,,02
84,4444444444444444444444444444444444444444444444444444444444444444444444444444444444444444,bbbbbbbbbbbbbbbbbbbbbbbbbbbbbbbbbbbbbbbbbbbbbbbbbbbbbbbbbbbb1111,pkh95,e12qxtiuywt1cun9q6cszdtruvgqbmqvncdrjnr7cvs0mapghrgrepqofmtowfbd,nzgonnaj,,,02,,,,5202,2021-07-10 16: 36:10,3000,2093971,,,김동주,,,02
85,4444444444444444444444444444444444444444444444444444444444444444444444444444444444444444,bbbbbbbbbbbbbbbbbbbbbbbbbbbbbbbbbbbbbbbbbbbbbbbbbbbbbbbbbbbb1111,pkh95,,,,,02,,,,5901,2021-07-12 05: 56:18,13,2093984,,,,,,02
86,4444444444444444444444444444444444444444444444444444444444444444444444444444444444444444,bbbbbbbbbbbbbbbbbbbbbbbbbbbbbbbbbbbbbbbbbbbbbbbbbbbbbbbbbbbb1111,pkh95,,,,,02,,,,5901,2021-07-19 06: 00:33,10,2093994,,,,,,02
87,4444444444444444444444444444444444444444444444444444444444444444444444444444444444444444,bbbbbbbbbbbbbbbbbbbbbbbbbbbbbbbbbbbbbbbbbbbbbbbbbbbbbbbbbbbb1111,pkh95,,,,,02,,,,5501,2021-07-20 12: 18:16,9000,2084994,,,짬뽕콤보(짬+탕+군+음),,A1,02
88,4444444444444444444444444444444444444444444444444444444444444444444444444444444444444444,bbbbbbbbbbbbbbbbbbbbbbbbbbbbbbbbbbbbbbbbbbbbbbbbbbbbbbbbbbbb1111,pkh95,,,,,02,,,,5501,2021-07-21 20: 16:59,1000,2083994,,,일일권(1시간),,K1,02
89,4444444444444444444444444444444444444444444444444444444444444444444444444444444444444444,bbbbbbbbbbbbbbbbbbbbbbbbbbbbbbbbbbbbbbbbbbbbbbbbbbbbbbbbbbbb1111,pkh95,,,,,02,,,,5901,2021-07-26 05: 58:28,9,2084003,,,,,,02
90,4444444444444444444444444444444444444444444444444444444444444444444444444444444444444444,bbbbbbbbbbbbbbbbbbbbbbbbbbbbbbbbbbbbbbbbbbbbbbbbbbbbbbbbbbbb1111,pkh95,,,,,02,,,,nan,11:02,111,2083892,,,,,,02
91,4444444444444444444444444444444444444444444444444444444444444444444444444444444444444444,bbbbbbbbbbbbbbbbbbbbbbbbbbbbbbbbbbbbbbbbbbbbbbbbbbbbbbbbbbbb1111,pkh95,143vu1uz98aqzz7oehk9jbgnh0udew8idawbtfamwka8iqowvg8hwijh4sm2kc9c,zgruktkg,,,02,,,,5201,2021-07-31 12: 22:27,57000,2026892,농협,110-42-987654,***2472 권*현,,,02
92,4444444444444444444444444444444444444444444444444444444444444444444444444444444444444444,bbbbbbbbbbbbbbbbbbbbbbbbbbbbbbbbbbbbbbbbbbbbbbbbbbbbbbbbbbbb1111,pkh95,z8j0zliqlw8gsy002mh31urxtp08zngy8oqz398n7i2t4c9cnzh3qbrb74fqdtlk,glfdvtee,,,02,,,,5901,2021-07-31 16: 48:30,320,2027212,,,김명수,,,02
93,4444444444444444444444444444444444444444444444444444444444444444444444444444444444444444,bbbbbbbbbbbbbbbbbbbbbbbbbbbbbbbbbbbbbbbbbbbbbbbbbbbbbbbbbbbb1111,pkh95,,,,,02,,,,5901,2021-08-02 05:58:27,8,2027220,,,,,,02
94,4444444444444444444444444444444444444444444444444444444444444444444444444444444444444444,bbbbbbbbbbbbbbbbbbbbbbbbbbbbbbbbbbbbbbbbbbbbbbbbbbbbbbbbbbbb1111,pkh95,,,,,02,,,,5501,2021-08-05 18: 13:40,1000,2026220,,,일일권(1시간),,K1,02
95,4444444444444444444444444444444444444444444444444444444444444444444444444444444444444444,bbbbbbbbbbbbbbbbbbbbbbbbbbbbbbbbbbbbbbbbbbbbbbbbbbbbbbbbbbbb1111,pkh95,,,,,02,,,,5501,2021-08-07 12: 13:25,1000,2025220,,,일일권(1시간),,K1,02
96,4444444444444444444444444444444444444444444444444444444444444444444444444444444444444444,bbbbbbbbbbbbbbbbbbbbbbbbbbbbbbbbbbbbbbbbbbbbbbbbbbbbbbbbbbbb1111,pkh95,,,,,02,,,,5901,2021-08-09 06:01:31,3,2025223,,,,,,02
97,4444444444444444444444444444444444444444444444444444444444444444444444444444444444444444,bbbbbbbbbbbbbbbbbbbbbbbbbbbbbbbbbbbbbbbbbbbbbbbbbbbbbbbbbbbb1111,pkh95,,,신한,110-42-987654,02,,2000000.0,10000.0,5102,2021-08-09 14: 28:41,10000,2035223,,,***2744 박*훈,,,02
98,4444444444444444444444444444444444444444444444444444444444444444444444444444444444444444,bbbbbbbbbbbbbbbbbbbbbbbbbbbbbbbbbbbbbbbbbbbbbbbbbbbbbbbbbbbb1111,pkh95,2goi4hu03kxy2bncot514brvjp2tvwqz3pz7axdx442dkdua7ilrjk7ep08jsta6,qbgxyzcm,,,02,,,,5201,2021-08-09 14: 28:41,28000,2007223,"IBK
기업",110-42-987654,***0760 신*식,,,02
99,4444444444444444444444444444444444444444444444444444444444444444444444444444444444444444,bbbbbbbbbbbbbbbbbbbbbbbbbbbbbbbbbbbbbbbbbbbbbbbbbbbbbbbbbbbb1111,pkh95,suyc8xp0r5uyzy0l12q95iklvcdv99eneis5o6fu6kef23f0ozkchn53fn1q4yr7,qjwbolst,,,02,,,,5901,2021-08-16 00: 22:34,6501,2013724,,,이병훈,,,02
100,4444444444444444444444444444444444444444444444444444444444444444444444444444444444444444,bbbbbbbbbbbbbbbbbbbbbbbbbbbbbbbbbbbbbbbbbbbbbbbbbbbbbbbbbbbb1111,pkh95,,,,,02,,,,5901,2021-08-16 06: 02:04,1,2013725,,,,,,02
101,4444444444444444444444444444444444444444444444444444444444444444444444444444444444444444,bbbbbbbbbbbbbbbbbbbbbbbbbbbbbbbbbbbbbbbbbbbbbbbbbbbbbbbbbbbb1111,pkh95,,,,,02,,,,5901,2021-08-23 06:02:59,1,2013726,,,,,,02
102,4444444444444444444444444444444444444444444444444444444444444444444444444444444444444444,bbbbbbbbbbbbbbbbbbbbbbbbbbbbbbbbbbbbbbbbbbbbbbbbbbbbbbbbbbbb1111,pkh95,,,,,02,,,,5501,2021-08-25 19: 48:53,1000,2012726,,,일일권(1시간),,K1,02
103,4444444444444444444444444444444444444444444444444444444444444444444444444444444444444444,bbbbbbbbbbbbbbbbbbbbbbbbbbbbbbbbbbbbbbbbbbbbbbbbbbbbbbbbbbbb1111,pkh95,,,,,02,,,,5501,2021-08-28 18: 45:58,10600,2002126,,,맥치킨? 모짜렐라 세 트 외 2건,,Z1,02
104,4444444444444444444444444444444444444444444444444444444444444444444444444444444444444444,bbbbbbbbbbbbbbbbbbbbbbbbbbbbbbbbbbbbbbbbbbbbbbbbbbbbbbbbbbbb1111,pkh95,,,,,02,,,,5901,2021-08-30 06:05:16,1,2002127,,,,,,02
105,4444444444444444444444444444444444444444444444444444444444444444444444444444444444444444,bbbbbbbbbbbbbbbbbbbbbbbbbbbbbbbbbbbbbbbbbbbbbbbbbbbbbbbbbbbb1111,pkh95,suyc8xp0r5uyzy0l12q95iklvcdv99eneis5o6fu6kef23f0ozkchn53fn1q4yr7,qjwbolst,,,02,,,,5901,2021-09-04 15: 46:59,28000,2030127,,,이병훈,,,02
106,4444444444444444444444444444444444444444444444444444444444444444444444444444444444444444,bbbbbbbbbbbbbbbbbbbbbbbbbbbbbbbbbbbbbbbbbbbbbbbbbbbbbbbbbbbb1111,pkh95,e12qxtiuywt1cun9q6cszdtruvgqbmqvncdrjnr7cvs0mapghrgrepqofmtowfbd,nzgonnaj,,,02,,,,5202,2021-09-04 17: 15:20,11501,2018626,,,김동주,,,02
107,4444444444444444444444444444444444444444444444444444444444444444444444444444444444444444,bbbbbbbbbbbbbbbbbbbbbbbbbbbbbbbbbbbbbbbbbbbbbbbbbbbbbbbbbbbb1111,pkh95,cm8ztnbeu0zxmw4ly3p53d37d2rt91vicfz9jxpzvb12kxcs9gk994h4uu7gwt7w,nuuoqgqb,,,02,,,,5201,2021-09-06 21: 37:19,5000,2013626,카카 오뱅 크,110-42-987654,***9317 정*헌,,,02
108,4444444444444444444444444444444444444444444444444444444444444444444444444444444444444444,bbbbbbbbbbbbbbbbbbbbbbbbbbbbbbbbbbbbbbbbbbbbbbbbbbbbbbbbbbbb1111,pkh95,,,,,02,,,,5901,2021-09-13 04: 58:02,1,2013627,,,,,,02
109,4444444444444444444444444444444444444444444444444444444444444444444444444444444444444444,bbbbbbbbbbbbbbbbbbbbbbbbbbbbbbbbbbbbbbbbbbbbbbbbbbbbbbbbbbbb1111,pkh95,,,,,02,,,,5501,2021-09-17 12: 22:13,5200,2008427,,,"남양)초코에몽250ml
외 3개",,L1,02
110,4444444444444444444444444444444444444444444444444444444444444444444444444444444444444444,bbbbbbbbbbbbbbbbbbbbbbbbbbbbbbbbbbbbbbbbbbbbbbbbbbbbbbbbbbbb1111,pkh95,,,,,02,,,,5901,2021-09-20 05:00:30,1,2008428,,,,,,02
111,4444444444444444444444444444444444444444444444444444444444444444444444444444444444444444,bbbbbbbbbbbbbbbbbbbbbbbbbbbbbbbbbbbbbbbbbbbbbbbbbbbbbbbbbbbb1111,pkh95,,,신한,110-42-987654,02,,2000000.0,20000.0,5102,2021-09-21 22: 33:14,20000,2028428,,,***2744 박*훈,,,02
112,4444444444444444444444444444444444444444444444444444444444444444444444444444444444444444,bbbbbbbbbbbbbbbbbbbbbbbbbbbbbbbbbbbbbbbbbbbbbbbbbbbbbbbbbbbb1111,pkh95,8npvpf2wdqakx4sfio2ounof7v9w7a9brgg8sq3i68rfjkqyywegualn5rhkc8to,sakyfyse,,,02,,,,5202,2021-09-21 22: 33:14,24903,2003525,,,명쑤,,,02
113,4444444444444444444444444444444444444444444444444444444444444444444444444444444444444444,bbbbbbbbbbbbbbbbbbbbbbbbbbbbbbbbbbbbbbbbbbbbbbbbbbbbbbbbbbbb1111,pkh95,,,,,02,,,,5501,2021-09-23 19: 42:01,250,2003275,,,퍼페티)츄파춥스250,,L1,02
114,4444444444444444444444444444444444444444444444444444444444444444444444444444444444444444,bbbbbbbbbbbbbbbbbbbbbbbbbbbbbbbbbbbbbbbbbbbbbbbbbbbbbbbbbbbb1111,pkh95,,,신한,110-42-987654,02,,2000000.0,26715.0,5102,2021-09-24 00:16:22,26715,2029990,,,***2744 박*훈,,,02
115,4444444444444444444444444444444444444444444444444444444444444444444444444444444444444444,bbbbbbbbbbbbbbbbbbbbbbbbbbbbbbbbbbbbbbbbbbbbbbbbbbbbbbbbbbbb1111,pkh95,,,,,02,,,,5501,2021-09-24 00:16:22,29900,2000090,,,스페로스페라 크레페케 이크 (톡별),,J1,02
116,4444444444444444444444444444444444444444444444444444444444444444444444444444444444444444,bbbbbbbbbbbbbbbbbbbbbbbbbbbbbbbbbbbbbbbbbbbbbbbbbbbbbbbbbbbb1111,pkh95,,,신한,110-42-987654,02,,2000000.0,10000.0,5102,2021-09-25 11: 28:56,10000,2010090,,,***2744 박*훈,,,02
117,4444444444444444444444444444444444444444444444444444444444444444444444444444444444444444,bbbbbbbbbbbbbbbbbbbbbbbbbbbbbbbbbbbbbbbbbbbbbbbbbbbbbbbbbbbb1111,pkh95,,,,,02,,,,5501,2021-09-25 11: 28:56,3000,2007090,,,[BBQ] 황금올리브치킨 반반+콜라 1.25L,,G1,02
118,4444444444444444444444444444444444444444444444444444444444444444444444444444444444444444,bbbbbbbbbbbbbbbbbbbbbbbbbbbbbbbbbbbbbbbbbbbbbbbbbbbbbbbbbbbb1111,pkh95,,,신한,110-42-987654,02,,2000000.0,23000.0,5102,2021-09-27 17: 31:38,23000,2030090,,,***2744 박*훈,,,02
119,4444444444444444444444444444444444444444444444444444444444444444444444444444444444444444,bbbbbbbbbbbbbbbbbbbbbbbbbbbbbbbbbbbbbbbbbbbbbbbbbbbbbbbbbbbb1111,pkh95,,,,,02,,,,5501,2021-09-27 17: 31:38,30000,2000090,,,e카드 3만원 교환권,,I1,02
120,4444444444444444444444444444444444444444444444444444444444444444444444444444444444444444,bbbbbbbbbbbbbbbbbbbbbbbbbbbbbbbbbbbbbbbbbbbbbbbbbbbbbbbbbbbb1111,pkh95,,,신한,110-42-987654,02,,2000000.0,10000.0,5102,2021-10-01 14: 56:33,10000,2010090,,,***2744 박*훈,,,02
121,4444444444444444444444444444444444444444444444444444444444444444444444444444444444444444,bbbbbbbbbbbbbbbbbbbbbbbbbbbbbbbbbbbbbbbbbbbbbbbbbbbbbbbbbbbb1111,pkh95,,,,,02,,,,5501,2021-10-01 14: 56:33,1000,2009090,,,빙그레)메로나,,Z1,02
122,4444444444444444444444444444444444444444444444444444444444444444444444444444444444444444,bbbbbbbbbbbbbbbbbbbbbbbbbbbbbbbbbbbbbbbbbbbbbbbbbbbbbbbbbbbb1111,pkh95,,,신한,110-42-987654,02,,2000000.0,10000.0,5102,2021-10-03 18: 35:02,10000,2019090,,,***2744 박*훈,,,02
123,4444444444444444444444444444444444444444444444444444444444444444444444444444444444444444,bbbbbbbbbbbbbbbbbbbbbbbbbbbbbbbbbbbbbbbbbbbbbbbbbbbbbbbbbbbb1111,pkh95,,,,,02,,,,5501,2021-10-03 18: 35:02,10200,2008890,,,1인 보쌈도시락,,A1,02
124,4444444444444444444444444444444444444444444444444444444444444444444444444444444444444444,bbbbbbbbbbbbbbbbbbbbbbbbbbbbbbbbbbbbbbbbbbbbbbbbbbbbbbbbbbbb1111,pkh95,,,신한,110-42-987654,02,,2000000.0,10000.0,5102,2021-10-09 13: 06:29,10000,2018890,,,***2744 박*훈,,,02
125,4444444444444444444444444444444444444444444444444444444444444444444444444444444444444444,bbbbbbbbbbbbbbbbbbbbbbbbbbbbbbbbbbbbbbbbbbbbbbbbbbbbbbbbbbbb1111,pkh95,,,,,02,,,,5501,2021-10-09 13: 06:29,9900,2008990,,,1200 RP,,I1,02
126,4444444444444444444444444444444444444444444444444444444444444444444444444444444444444444,bbbbbbbbbbbbbbbbbbbbbbbbbbbbbbbbbbbbbbbbbbbbbbbbbbbbbbbbbbbb1111,pkh95,,,,,02,,,,5901,2021-10-11 05: 01:16,1,2008991,,,,,,02
127,4444444444444444444444444444444444444444444444444444444444444444444444444444444444444444,bbbbbbbbbbbbbbbbbbbbbbbbbbbbbbbbbbbbbbbbbbbbbbbbbbbbbbbbbbbb1111,pkh95,,,,,02,,,,5901,2021-10-18 05: 00:07,1,2008992,,,,,,02
128,4444444444444444444444444444444444444444444444444444444444444444444444444444444444444444,bbbbbbbbbbbbbbbbbbbbbbbbbbbbbbbbbbbbbbbbbbbbbbbbbbbbbbbbbbbb1111,pkh95,5re7phe6tzpmunnoaxe3xrclegie5zjo7lr88pf4y8ev7ewt67t50gxpfnbdfjjm,ffbmyyer,,,02,,,,5901,2021-10-22 13:33,2500,2011492,,,염예진,,,02
129,4444444444444444444444444444444444444444444444444444444444444444444444444444444444444444,bbbbbbbbbbbbbbbbbbbbbbbbbbbbbbbbbbbbbbbbbbbbbbbbbbbbbbbbbbbb1111,pkh95,,,,,02,,,,5901,2021-10-25 05: 17:42,1,2011493,,,,,,02
130,4444444444444444444444444444444444444444444444444444444444444444444444444444444444444444,bbbbbbbbbbbbbbbbbbbbbbbbbbbbbbbbbbbbbbbbbbbbbbbbbbbbbbbbbbbb1111,pkh95,z2v8strnrc3otcjs6brj8nrmbn2kwkpc31aq60wa7teq6omv3zp37p6yj2u0enus,hnegkxow,,,02,,,,5901,2021-10-28 20: 18:20,28000,2039493,,,Yu,,,02
131,4444444444444444444444444444444444444444444444444444444444444444444444444444444444444444,bbbbbbbbbbbbbbbbbbbbbbbbbbbbbbbbbbbbbbbbbbbbbbbbbbbbbbbbbbbb1111,pkh95,v6i52ae1lztidujw9fv6t0uupyvunothzgrp1rfiqsdiocyhlve9s94w5xequeoa,wvdkqrvc,,,02,,,,5901,2021-10-28 20: 20:38,28000,2067493,,,송병학,,,02
132,4444444444444444444444444444444444444444444444444444444444444444444444444444444444444444,bbbbbbbbbbbbbbbbbbbbbbbbbbbbbbbbbbbbbbbbbbbbbbbbbbbbbbbbbbbb1111,pkh95,,,신한,110-42-987654,02,,2000000.0,40000.0,5102,2021-10-31 20: 27:50,40000,2107493,,,***2744 박*훈,,,02
133,4444444444444444444444444444444444444444444444444444444444444444444444444444444444444444,bbbbbbbbbbbbbbbbbbbbbbbbbbbbbbbbbbbbbbbbbbbbbbbbbbbbbbbbbbbb1111,pkh95,iexhxjk80j68j6c6da4mhgfd8e8h4bxmdee9thb9e3cfi4a42fbeucbnw61ok25u,zumkqxfv,,,02,,,,5202,2021-10-31 20: 27:50,100000,2007493,,,형,,,02
134,4444444444444444444444444444444444444444444444444444444444444444444444444444444444444444,bbbbbbbbbbbbbbbbbbbbbbbbbbbbbbbbbbbbbbbbbbbbbbbbbbbbbbbbbbbb1111,pkh95,,,,,02,,,,5901,2021-11-01 05: 47:53,4,2007497,,,,,,02
135,4444444444444444444444444444444444444444444444444444444444444444444444444444444444444444,bbbbbbbbbbbbbbbbbbbbbbbbbbbbbbbbbbbbbbbbbbbbbbbbbbbbbbbbbbbb1111,pkh95,1glds0lovd3fv6yl5pifo0yy3t7gj3vm3ukne8pffpzybdr63nxyhlss594g2ez0,gmqthuju,,,02,,,,5901,2021-11-04 11: 44:54,8000,2015497,,,재현,,,02
136,4444444444444444444444444444444444444444444444444444444444444444444444444444444444444444,bbbbbbbbbbbbbbbbbbbbbbbbbbbbbbbbbbbbbbbbbbbbbbbbbbbbbbbbbbbb1111,pkh95,4ten04o95k9ot1fyitn4al8m161g2rey1ss4f4l4bwfscj8jl7wb5t0ubsh9b3mv,cfcayxwe,,,02,,,,5202,2021-11-04 11: 45:07,7999,2007498,,,윤재현,,,02
137,4444444444444444444444444444444444444444444444444444444444444444444444444444444444444444,bbbbbbbbbbbbbbbbbbbbbbbbbbbbbbbbbbbbbbbbbbbbbbbbbbbbbbbbbbbb1111,pkh95,,,신한,110-42-987654,02,,2000000.0,10000.0,5102,2021-11-10 17: 35:31,10000,2017498,,,***2744 박*훈,,,02
138,4444444444444444444444444444444444444444444444444444444444444444444444444444444444444444,bbbbbbbbbbbbbbbbbbbbbbbbbbbbbbbbbbbbbbbbbbbbbbbbbbbbbbbbbbbb1111,pkh95,,,,,02,,,,5501,2021-11-10 17: 35:31,8000,2009498,,,화이트갈릭와퍼 세트,,A1,02
139,4444444444444444444444444444444444444444444444444444444444444444444444444444444444444444,bbbbbbbbbbbbbbbbbbbbbbbbbbbbbbbbbbbbbbbbbbbbbbbbbbbbbbbbbbbb1111,pkh95,,,,,02,,,,5501,2021-11-11 11: 09:06,4500,2004998,,,롯데)누드빼빼로1500 외 2개,,I1,02
140,4444444444444444444444444444444444444444444444444444444444444444444444444444444444444444,bbbbbbbbbbbbbbbbbbbbbbbbbbbbbbbbbbbbbbbbbbbbbbbbbbbbbbbbbbbb1111,pkh95,,,,,02,,,,5501,2021-11-11 11:10: 57,3000,2001998,,,롯데)누드빼빼로1500 외 1개,,H1,02
141,4444444444444444444444444444444444444444444444444444444444444444444444444444444444444444,bbbbbbbbbbbbbbbbbbbbbbbbbbbbbbbbbbbbbbbbbbbbbbbbbbbbbbbbbbbb1111,pkh95,suyc8xp0r5uyzy0l12q95iklvcdv99eneis5o6fu6kef23f0ozkchn53fn1q4yr7,qjwbolst,,,02,,,,5901,2021-11-12 19: 43:17,10000,2011998,,,이병훈,,,02
142,4444444444444444444444444444444444444444444444444444444444444444444444444444444444444444,bbbbbbbbbbbbbbbbbbbbbbbbbbbbbbbbbbbbbbbbbbbbbbbbbbbbbbbbbbbb1111,pkh95,8npvpf2wdqakx4sfio2ounof7v9w7a9brgg8sq3i68rfjkqyywegualn5rhkc8to,sakyfyse,,,02,,,,5202,2021-11-13 22: 05:05,1401,2010597,,,명쑤,,,02
143,4444444444444444444444444444444444444444444444444444444444444444444444444444444444444444,bbbbbbbbbbbbbbbbbbbbbbbbbbbbbbbbbbbbbbbbbbbbbbbbbbbbbbbbbbbb1111,pkh95,wwrrk02pkqaw54hqxkadgibwahn2r4dcte9jx5clcwbf0gnfjfw0h4gu0be3x75s,tdrdmjla,,,02,,,,5901,2021-11-15 17: 51:47,1325,2011922,,,신효식,,,02
144,4444444444444444444444444444444444444444444444444444444444444444444444444444444444444444,bbbbbbbbbbbbbbbbbbbbbbbbbbbbbbbbbbbbbbbbbbbbbbbbbbbbbbbbbbbb1111,pkh95,,,,,02,,,,nan,2021-11-15 17: 53:45,1330,2010592,,,,,,02
145,4444444444444444444444444444444444444444444444444444444444444444444444444444444444444444,bbbbbbbbbbbbbbbbbbbbbbbbbbbbbbbbbbbbbbbbbbbbbbbbbbbbbbbbbbbb1111,pkh95,,,,,02,,,,5901,2021-11-22 04: 53:59,1,2010593,,,정기 예탁금 수익,,,02
146,4444444444444444444444444444444444444444444444444444444444444444444444444444444444444444,bbbbbbbbbbbbbbbbbbbbbbbbbbbbbbbbbbbbbbbbbbbbbbbbbbbbbbbbbbbb1111,pkh95,,,신한,110-42-987654,02,,2000000.0,10000.0,5102,2021-11-24 11: 16:42,10000,2020593,,,***2744 박*훈,,,02
147,4444444444444444444444444444444444444444444444444444444444444444444444444444444444444444,bbbbbbbbbbbbbbbbbbbbbbbbbbbbbbbbbbbbbbbbbbbbbbbbbbbbbbbbbbbb1111,pkh95,t011nhkyp5pj9987rowl01924fglt6mf50b1a21djvp3n0iufai89z6w9g7q3oxi,gimzyhtk,,,02,,,,5201,2021-11-24 11: 16:42,15000,2005593,국민,110-42-987654,***9511 김*주,,,02
148,4444444444444444444444444444444444444444444444444444444444444444444444444444444444444444,bbbbbbbbbbbbbbbbbbbbbbbbbbbbbbbbbbbbbbbbbbbbbbbbbbbbbbbbbbbb1111,pkh95,,,신한,110-42-987654,02,,2000000.0,10000.0,5102,2021-11-24 17: 37:34,10000,2015593,,,***2744 박*훈,,,02
149,4444444444444444444444444444444444444444444444444444444444444444444444444444444444444444,bbbbbbbbbbbbbbbbbbbbbbbbbbbbbbbbbbbbbbbbbbbbbbbbbbbbbbbbbbbb1111,pkh95,3dvulxeylk5ww7ol3ueed911tmk0gv3olda5cbojy6mtgwlrgkcq5hnv1nj4j9kj,dqeympgh,,,02,,,,5201,2021-11-24 17: 37:34,14000,2001593,"IBK
기업",110-42-987654,***1011 조*진,,,02
150,4444444444444444444444444444444444444444444444444444444444444444444444444444444444444444,bbbbbbbbbbbbbbbbbbbbbbbbbbbbbbbbbbbbbbbbbbbbbbbbbbbbbbbbbbbb1111,pkh95,,,,,02,,,,5501,2021-11-25 11: 47:41,1250,2000343,,,농심)사리곰탕큰사발면,,K1,02
151,4444444444444444444444444444444444444444444444444444444444444444444444444444444444444444,bbbbbbbbbbbbbbbbbbbbbbbbbbbbbbbbbbbbbbbbbbbbbbbbbbbbbbbbbbbb1111,pkh95,,,신한,110-42-987654,02,,2000000.0,15647.0,5102,2021-11-27 12: 09:26,15647,2015990,,,***2744 박*훈,,,02
152,4444444444444444444444444444444444444444444444444444444444444444444444444444444444444444,bbbbbbbbbbbbbbbbbbbbbbbbbbbbbbbbbbbbbbbbbbbbbbbbbbbbbbbbbbbb1111,pkh95,,,,,02,,,,5501,2021-11-27 12: 09:26,15900,2000090,,,우주 비행사 냥 LED 무 드등,,Z1,02
153,4444444444444444444444444444444444444444444444444444444444444444444444444444444444444444,bbbbbbbbbbbbbbbbbbbbbbbbbbbbbbbbbbbbbbbbbbbbbbbbbbbbbbbbbbbb1111,pkh95,,,신한,110-42-987654,02,,2000000.0,50000.0,5102,2021-12-07 10: 07:24,50000,2050090,,,***2744 박*훈,,,02
154,4444444444444444444444444444444444444444444444444444444444444444444444444444444444444444,bbbbbbbbbbbbbbbbbbbbbbbbbbbbbbbbbbbbbbbbbbbbbbbbbbbbbbbbbbbb1111,pkh95,,,,,02,,,,5501,2021-12-07 10: 07:24,50000,2000090,,,모바일 금액권 5만원권,,H1,02
155,4444444444444444444444444444444444444444444444444444444444444444444444444444444444444444,bbbbbbbbbbbbbbbbbbbbbbbbbbbbbbbbbbbbbbbbbbbbbbbbbbbbbbbbbbbb1111,pkh95,,,신한,110-42-987654,02,,2000000.0,20000.0,5102,2021-12-07 15: 02:44,20000,2020090,,,***2744 박*훈,,,02
156,4444444444444444444444444444444444444444444444444444444444444444444444444444444444444444,bbbbbbbbbbbbbbbbbbbbbbbbbbbbbbbbbbbbbbbbbbbbbbbbbbbbbbbbbbbb1111,pkh95,qlixj5sheedfyu0urfhe8bbsuw3kteyqlq084yrv6tbscdqt1x21mtf5mbrp47kx,uszwzfqp,,,02,,,,5202,2021-12-07 15: 02:44,11000,2009090,,,최승언,,,02
157,4444444444444444444444444444444444444444444444444444444444444444444444444444444444444444,bbbbbbbbbbbbbbbbbbbbbbbbbbbbbbbbbbbbbbbbbbbbbbbbbbbbbbbbbbbb1111,pkh95,,,,,02,,,,5901,2021-12-20 04: 50:39,1,2009091,,,정기 예탁금 수익,,,02
158,1111111111111111111111111111111111111111111111111111111111111111111111111111111111111111,aaaaaaaaaaaaaaaaaaaaaaaaaaaaaaaaaaaaaaaaaaaaaaaaaaaaaaaaaaaa1111,yummy,,,신한,110-63-123456,02,,2000000.0,10000.0,5102,2021-07-01 11: 10:21,10000,2010000,,,***6391 염*진,,,01
159,1111111111111111111111111111111111111111111111111111111111111111111111111111111111111111,aaaaaaaaaaaaaaaaaaaaaaaaaaaaaaaaaaaaaaaaaaaaaaaaaaaaaaaaaaaa1111,yummy,1din42viky7ewvghk71k6vzffsn8axhaq9bqizffq9mjc3nyeshxtag235nyrjvm,uclravtk,,,02,,,,5201,2021-07-01 11: 10:21,15000,1995000,국민,110-63-123456,***5351 조*영,,,01
160,1111111111111111111111111111111111111111111111111111111111111111111111111111111111111111,aaaaaaaaaaaaaaaaaaaaaaaaaaaaaaaaaaaaaaaaaaaaaaaaaaaaaaaaaaaa1111,yummy,,,신한,110-63-123456,02,,2000000.0,20000.0,5102,2021-07-01 14: 57:49,20000,2015000,,,***6391 염*진,,,01
161,1111111111111111111111111111111111111111111111111111111111111111111111111111111111111111,aaaaaaaaaaaaaaaaaaaaaaaaaaaaaaaaaaaaaaaaaaaaaaaaaaaaaaaaaaaa1111,yummy,d2rah4uitwhjtdw6brmktbmpw1mzdauyn0a06ae7er6k9wvym8bq6s50o26deasg,clpbexbj,,,02,,,,5202,2021-07-01 14: 57:49,22700,1992300,,,혜또취,,,01
162,1111111111111111111111111111111111111111111111111111111111111111111111111111111111111111,aaaaaaaaaaaaaaaaaaaaaaaaaaaaaaaaaaaaaaaaaaaaaaaaaaaaaaaaaaaa1111,yummy,,,신한,110-63-123456,02,,2000000.0,30000.0,5102,2021-07-02 22: 38:28,30000,2022300,,,***6391 염*진,,,01
163,1111111111111111111111111111111111111111111111111111111111111111111111111111111111111111,aaaaaaaaaaaaaaaaaaaaaaaaaaaaaaaaaaaaaaaaaaaaaaaaaaaaaaaaaaaa1111,yummy,reitdq9ik8844wbjrbwiun69nlw7pnq9l4vng1sr50v5iffqaxbhl93tlho1fieq,nwzksrjd,,,02,,,,5201,2021-07-02 22: 38:28,25000,1997300,국민,110-63-123456,***8748 이*재,,,01
164,1111111111111111111111111111111111111111111111111111111111111111111111111111111111111111,aaaaaaaaaaaaaaaaaaaaaaaaaaaaaaaaaaaaaaaaaaaaaaaaaaaaaaaaaaaa1111,yummy,,,신한,110-63-123456,02,,2000000.0,10000.0,5102,2021-07-05 13: 21:50,10000,2007300,,,***6391 염*진,,,01
165,1111111111111111111111111111111111111111111111111111111111111111111111111111111111111111,aaaaaaaaaaaaaaaaaaaaaaaaaaaaaaaaaaaaaaaaaaaaaaaaaaaaaaaaaaaa1111,yummy,d2rah4uitwhjtdw6brmktbmpw1mzdauyn0a06ae7er6k9wvym8bq6s50o26deasg,clpbexbj,,,02,,,,5202,2021-07-05 13: 21:50,12600,1994700,,,혜또취,,,01
166,1111111111111111111111111111111111111111111111111111111111111111111111111111111111111111,aaaaaaaaaaaaaaaaaaaaaaaaaaaaaaaaaaaaaaaaaaaaaaaaaaaaaaaaaaaa1111,yummy,vpntzehvs95z6rn1q2s8a1116sukip8c7g5bm23qdujfx9p9yro1yms5w6ozayqo,jbwbesja,,,02,,,,5901,2021-07-07 07: 44:15,23500,2018200,,,혜원,,,01
167,1111111111111111111111111111111111111111111111111111111111111111111111111111111111111111,aaaaaaaaaaaaaaaaaaaaaaaaaaaaaaaaaaaaaaaaaaaaaaaaaaaaaaaaaaaa1111,yummy,vpntzehvs95z6rn1q2s8a1116sukip8c7g5bm23qdujfx9p9yro1yms5w6ozayqo,jbwbesja,,,02,,,,5901,2021-07-07 07: 44:22,4500,2022700,,,혜원,,,01
168,1111111111111111111111111111111111111111111111111111111111111111111111111111111111111111,aaaaaaaaaaaaaaaaaaaaaaaaaaaaaaaaaaaaaaaaaaaaaaaaaaaaaaaaaaaa1111,yummy,db0vt0hrlblp90v94jcaknnu6p7zg71pc17ij91scjl78nodie69kt45fqmxuj4g,thrbpuku,,,02,,,,5202,2021-07-07 12: 29:41,8000,2014700,,,닉컴퍼니_최승언,,,01
169,1111111111111111111111111111111111111111111111111111111111111111111111111111111111111111,aaaaaaaaaaaaaaaaaaaaaaaaaaaaaaaaaaaaaaaaaaaaaaaaaaaaaaaaaaaa1111,yummy,vpntzehvs95z6rn1q2s8a1116sukip8c7g5bm23qdujfx9p9yro1yms5w6ozayqo,jbwbesja,,,02,,,,5901,2021-07-09 14: 20:37,2750,2017450,,,혜원,,,01
170,1111111111111111111111111111111111111111111111111111111111111111111111111111111111111111,aaaaaaaaaaaaaaaaaaaaaaaaaaaaaaaaaaaaaaaaaaaaaaaaaaaaaaaaaaaa1111,yummy,7eduno9xcrrzswjqzf9h2cgwa7ij75nqrbitp6mnzef6na66xdmk4vd171dz8amm,lndnirai,,,02,,,,5901,2021-07-09 16: 17:40,5547,2022997,,,박재홍,,,01
171,1111111111111111111111111111111111111111111111111111111111111111111111111111111111111111,aaaaaaaaaaaaaaaaaaaaaaaaaaaaaaaaaaaaaaaaaaaaaaaaaaaaaaaaaaaa1111,yummy,,,신한,110-63-123456,02,,2000000.0,40000.0,5102,2021-07-18 18: 17:03,40000,2062997,,,***6391 염*진,,,01
172,1111111111111111111111111111111111111111111111111111111111111111111111111111111111111111,aaaaaaaaaaaaaaaaaaaaaaaaaaaaaaaaaaaaaaaaaaaaaaaaaaaaaaaaaaaa1111,yummy,rgc8mrxp8924yf7yx41172sylofbrre6r9e7hmqszxtw2q216tb3m7j9fnlz720p,cnpgvjqf,,,02,,,,5201,2021-07-18 18: 17:03,65000,1997997,우리,110-63-123456,***2004 오*름,,,01
173,1111111111111111111111111111111111111111111111111111111111111111111111111111111111111111,aaaaaaaaaaaaaaaaaaaaaaaaaaaaaaaaaaaaaaaaaaaaaaaaaaaaaaaaaaaa1111,yummy,,,,,02,,,,5501,2021-07-19 10: 38:09,2000,1995997,,,이모티콘샵,,Z1,01
174,1111111111111111111111111111111111111111111111111111111111111111111111111111111111111111,aaaaaaaaaaaaaaaaaaaaaaaaaaaaaaaaaaaaaaaaaaaaaaaaaaaaaaaaaaaa1111,yummy,,,신한,110-63-123456,02,,2000000.0,20000.0,5102,2021-07-19 11: 27:07,20000,2015997,,,***6391 염*진,,,01
175,1111111111111111111111111111111111111111111111111111111111111111111111111111111111111111,aaaaaaaaaaaaaaaaaaaaaaaaaaaaaaaaaaaaaaaaaaaaaaaaaaaaaaaaaaaa1111,yummy,x0gc3zsqrqymu1q5mfn8p96jodrgx02kst3depqll2chgp139fes3o08ylzwtpga,hbmbgomx,,,02,,,,5201,2021-07-19 11: 27:07,20000,1995997,우리,110-63-123456,***7165 박*진,,,01
176,1111111111111111111111111111111111111111111111111111111111111111111111111111111111111111,aaaaaaaaaaaaaaaaaaaaaaaaaaaaaaaaaaaaaaaaaaaaaaaaaaaaaaaaaaaa1111,yummy,,,신한,110-63-123456,02,,2000000.0,10000.0,5102,2021-07-19 12: 51:02,10000,2005997,,,***6391 염*진,,,01
177,1111111111111111111111111111111111111111111111111111111111111111111111111111111111111111,aaaaaaaaaaaaaaaaaaaaaaaaaaaaaaaaaaaaaaaaaaaaaaaaaaaaaaaaaaaa1111,yummy,d2rah4uitwhjtdw6brmktbmpw1mzdauyn0a06ae7er6k9wvym8bq6s50o26deasg,clpbexbj,,,02,,,,5202,2021-07-19 12: 51:03,13000,1992997,,,혜또취,,,01
178,1111111111111111111111111111111111111111111111111111111111111111111111111111111111111111,aaaaaaaaaaaaaaaaaaaaaaaaaaaaaaaaaaaaaaaaaaaaaaaaaaaaaaaaaaaa1111,yummy,,,신한,110-63-123456,02,,2000000.0,10000.0,5102,2021-07-19 14: 40:37,10000,2002997,,,***6391 염*진,,,01
179,1111111111111111111111111111111111111111111111111111111111111111111111111111111111111111,aaaaaaaaaaaaaaaaaaaaaaaaaaaaaaaaaaaaaaaaaaaaaaaaaaaaaaaaaaaa1111,yummy,,,,,02,,,,5501,2021-07-19 14: 40:37,3600,1999397,,,페레로)로쉐T-5,,H1,01
180,1111111111111111111111111111111111111111111111111111111111111111111111111111111111111111,aaaaaaaaaaaaaaaaaaaaaaaaaaaaaaaaaaaaaaaaaaaaaaaaaaaaaaaaaaaa1111,yummy,,,신한,110-63-123456,02,,2000000.0,10000.0,5102,2021-07-27 20: 47:17,10000,2009397,,,***6391 염*진,,,01
181,1111111111111111111111111111111111111111111111111111111111111111111111111111111111111111,aaaaaaaaaaaaaaaaaaaaaaaaaaaaaaaaaaaaaaaaaaaaaaaaaaaaaaaaaaaa1111,yummy,6brvp1v8vhwmqjz3y5ei6my1tjco12oq6hf5rbk187c4kgalajsmom76z3xx0v9n,loveppvj,,,02,,,,5201,2021-07-27 20: 47:17,15700,1993697,국민,110-63-123456,***9478 이*새,,,01
182,1111111111111111111111111111111111111111111111111111111111111111111111111111111111111111,aaaaaaaaaaaaaaaaaaaaaaaaaaaaaaaaaaaaaaaaaaaaaaaaaaaaaaaaaaaa1111,yummy,,,신한,110-63-123456,02,,2000000.0,40000.0,5102,2021-08-01 12: 48:04,40000,2033697,,,***6391 염*진,,,01
183,1111111111111111111111111111111111111111111111111111111111111111111111111111111111111111,aaaaaaaaaaaaaaaaaaaaaaaaaaaaaaaaaaaaaaaaaaaaaaaaaaaaaaaaaaaa1111,yummy,cde73umdtxx2ch3i6xkutipatxgugcsx5mzzew8z8wfc1js0gnq6z1ywm2meji8a,qzptchfv,,,02,,,,5202,2021-08-01 12: 48:04,40000,1993697,,,이지똥,,,01
184,1111111111111111111111111111111111111111111111111111111111111111111111111111111111111111,aaaaaaaaaaaaaaaaaaaaaaaaaaaaaaaaaaaaaaaaaaaaaaaaaaaaaaaaaaaa1111,yummy,,,신한,110-63-123456,02,,2000000.0,20000.0,5102,2021-08-06 10: 00:44,20000,2013697,,,***6391 염*진,,,01
185,1111111111111111111111111111111111111111111111111111111111111111111111111111111111111111,aaaaaaaaaaaaaaaaaaaaaaaaaaaaaaaaaaaaaaaaaaaaaaaaaaaaaaaaaaaa1111,yummy,cde73umdtxx2ch3i6xkutipatxgugcsx5mzzew8z8wfc1js0gnq6z1ywm2meji8a,qzptchfv,,,02,,,,5202,2021-08-06 10: 00:44,22000,1991697,,,이지똥,,,01
186,1111111111111111111111111111111111111111111111111111111111111111111111111111111111111111,aaaaaaaaaaaaaaaaaaaaaaaaaaaaaaaaaaaaaaaaaaaaaaaaaaaaaaaaaaaa1111,yummy,,,신한,110-63-123456,02,,2000000.0,21701.0,5102,2021-08-07 05:21:48,21701,2013398,,,***6391 염*진,,,01
187,1111111111111111111111111111111111111111111111111111111111111111111111111111111111111111,aaaaaaaaaaaaaaaaaaaaaaaaaaaaaaaaaaaaaaaaaaaaaaaaaaaaaaaaaaaa1111,yummy,,,,,02,,,,5501,2021-08-07 05:21:48,26900,1986498,,,인사이디 전동 마사지건 IMG-7 (전용가방 포함),,J1,01
188,1111111111111111111111111111111111111111111111111111111111111111111111111111111111111111,aaaaaaaaaaaaaaaaaaaaaaaaaaaaaaaaaaaaaaaaaaaaaaaaaaaaaaaaaaaa1111,yummy,,,신한,110-63-123456,02,,2000000.0,22000.0,5102,2021-08-07 06:20:28,22000,2008498,,,***6391 염*진,,,01
189,1111111111111111111111111111111111111111111111111111111111111111111111111111111111111111,aaaaaaaaaaaaaaaaaaaaaaaaaaaaaaaaaaaaaaaaaaaaaaaaaaaaaaaaaaaa1111,yummy,,,,,02,,,,5501,2021-08-07 06:20:28,22000,1986498,,,패밀리 아이스크림(배달 가능),,L1,01
190,1111111111111111111111111111111111111111111111111111111111111111111111111111111111111111,aaaaaaaaaaaaaaaaaaaaaaaaaaaaaaaaaaaaaaaaaaaaaaaaaaaaaaaaaaaa1111,yummy,vpntzehvs95z6rn1q2s8a1116sukip8c7g5bm23qdujfx9p9yro1yms5w6ozayqo,jbwbesja,,,02,,,,5901,2021-08-07 13: 47:59,6000,1992498,,,혜원,,,01
191,1111111111111111111111111111111111111111111111111111111111111111111111111111111111111111,aaaaaaaaaaaaaaaaaaaaaaaaaaaaaaaaaaaaaaaaaaaaaaaaaaaaaaaaaaaa1111,yummy,vpntzehvs95z6rn1q2s8a1116sukip8c7g5bm23qdujfx9p9yro1yms5w6ozayqo,jbwbesja,,,02,,,,5901,2021-08-10 11: 25:13,12900,2005398,,,혜원,,,01
192,1111111111111111111111111111111111111111111111111111111111111111111111111111111111111111,aaaaaaaaaaaaaaaaaaaaaaaaaaaaaaaaaaaaaaaaaaaaaaaaaaaaaaaaaaaa1111,yummy,vpntzehvs95z6rn1q2s8a1116sukip8c7g5bm23qdujfx9p9yro1yms5w6ozayqo,jbwbesja,,,02,,,,5901,2021-08-12 08: 03:54,33350,2038748,,,혜원,,,01
193,1111111111111111111111111111111111111111111111111111111111111111111111111111111111111111,aaaaaaaaaaaaaaaaaaaaaaaaaaaaaaaaaaaaaaaaaaaaaaaaaaaaaaaaaaaa1111,yummy,,,,,02,,,,5501,2021-08-13 14: 03:00,24000,2014748,,,치즈가 반한 티라미수(배 달가능),,A1,01
194,1111111111111111111111111111111111111111111111111111111111111111111111111111111111111111,aaaaaaaaaaaaaaaaaaaaaaaaaaaaaaaaaaaaaaaaaaaaaaaaaaaaaaaaaaaa1111,yummy,cde73umdtxx2ch3i6xkutipatxgugcsx5mzzew8z8wfc1js0gnq6z1ywm2meji8a,qzptchfv,,,02,,,,5202,2021-08-13 22: 58:42,16000,1998748,,,이지똥,,,01
195,1111111111111111111111111111111111111111111111111111111111111111111111111111111111111111,aaaaaaaaaaaaaaaaaaaaaaaaaaaaaaaaaaaaaaaaaaaaaaaaaaaaaaaaaaaa1111,yummy,vpntzehvs95z6rn1q2s8a1116sukip8c7g5bm23qdujfx9p9yro1yms5w6ozayqo,jbwbesja,,,02,,,,5901,2021-08-18 17: 58:11,15000,2013748,,,혜원,,,01
196,1111111111111111111111111111111111111111111111111111111111111111111111111111111111111111,aaaaaaaaaaaaaaaaaaaaaaaaaaaaaaaaaaaaaaaaaaaaaaaaaaaaaaaaaaaa1111,yummy,,,신한,110-63-123456,02,,2000000.0,50000.0,5102,2021-08-19 20: 44:19,50000,2063748,,,***6391 염*진,,,01
197,1111111111111111111111111111111111111111111111111111111111111111111111111111111111111111,aaaaaaaaaaaaaaaaaaaaaaaaaaaaaaaaaaaaaaaaaaaaaaaaaaaaaaaaaaaa1111,yummy,rgc8mrxp8924yf7yx41172sylofbrre6r9e7hmqszxtw2q216tb3m7j9fnlz720p,cnpgvjqf,,,02,,,,5201,2021-08-19 20: 44:19,70000,1993748,우리,110-63-123456,***2004 오*름,,,01
198,1111111111111111111111111111111111111111111111111111111111111111111111111111111111111111,aaaaaaaaaaaaaaaaaaaaaaaaaaaaaaaaaaaaaaaaaaaaaaaaaaaaaaaaaaaa1111,yummy,,,신한,110-63-123456,02,,2000000.0,40000.0,5102,2021-08-20 10: 48:39,40000,2033748,,,***6391 염*진,,,01
199,1111111111111111111111111111111111111111111111111111111111111111111111111111111111111111,aaaaaaaaaaaaaaaaaaaaaaaaaaaaaaaaaaaaaaaaaaaaaaaaaaaaaaaaaaaa1111,yummy,ieklfha4ebs2d4w6sl0ftwe1nfcy32f7z623jfuy2yrc1zq64fs019xkkdlirnvj,kwwjbkho,,,02,,,,5202,2021-08-20 10: 48:39,38000,1995748,,,서뉴,,,01
200,1111111111111111111111111111111111111111111111111111111111111111111111111111111111111111,aaaaaaaaaaaaaaaaaaaaaaaaaaaaaaaaaaaaaaaaaaaaaaaaaaaaaaaaaaaa1111,yummy,,,,,02,,,,5501,2021-08-29 02:44:13,11696,1984052,,,"[10PACK] 1507 모노 트
라우져 하프 삭스 _ 화이 트/블랙",,C1,01
201,1111111111111111111111111111111111111111111111111111111111111111111111111111111111111111,aaaaaaaaaaaaaaaaaaaaaaaaaaaaaaaaaaaaaaaaaaaaaaaaaaaaaaaaaaaa1111,yummy,,,신한,110-63-123456,02,,2000000.0,20000.0,5102,2021-09-01 13: 24:34,20000,2004052,,,***6391 염*진,,,01
202,1111111111111111111111111111111111111111111111111111111111111111111111111111111111111111,aaaaaaaaaaaaaaaaaaaaaaaaaaaaaaaaaaaaaaaaaaaaaaaaaaaaaaaaaaaa1111,yummy,d2rah4uitwhjtdw6brmktbmpw1mzdauyn0a06ae7er6k9wvym8bq6s50o26deasg,clpbexbj,,,02,,,,5202,2021-09-01 13: 24:34,13000,1991052,,,혜또취,,,01
203,1111111111111111111111111111111111111111111111111111111111111111111111111111111111111111,aaaaaaaaaaaaaaaaaaaaaaaaaaaaaaaaaaaaaaaaaaaaaaaaaaaaaaaaaaaa1111,yummy,,,신한,110-63-123456,02,,2000000.0,20000.0,5102,2021-09-02 10: 42:13,20000,2011052,,,***6391 염*진,,,01
204,1111111111111111111111111111111111111111111111111111111111111111111111111111111111111111,aaaaaaaaaaaaaaaaaaaaaaaaaaaaaaaaaaaaaaaaaaaaaaaaaaaaaaaaaaaa1111,yummy,9gyicnubsmbjwcmv0gcams6j950ksjsvrun15xvo8u4ug9fwutvuxzzopqikvq4w,mzjtkhbv,,,02,,,,5201,2021-09-02 10: 42:13,22000,1989052,국민,110-63-123456,***7094 박*진,,,01
205,1111111111111111111111111111111111111111111111111111111111111111111111111111111111111111,aaaaaaaaaaaaaaaaaaaaaaaaaaaaaaaaaaaaaaaaaaaaaaaaaaaaaaaaaaaa1111,yummy,,,신한,110-63-123456,02,,2000000.0,40000.0,5102,2021-09-03 12: 58:10,40000,2029052,,,***6391 염*진,,,01
206,1111111111111111111111111111111111111111111111111111111111111111111111111111111111111111,aaaaaaaaaaaaaaaaaaaaaaaaaaaaaaaaaaaaaaaaaaaaaaaaaaaaaaaaaaaa1111,yummy,d2rah4uitwhjtdw6brmktbmpw1mzdauyn0a06ae7er6k9wvym8bq6s50o26deasg,clpbexbj,,,02,,,,5202,2021-09-03 12: 58:10,38950,1990102,,,혜또취,,,01
207,1111111111111111111111111111111111111111111111111111111111111111111111111111111111111111,aaaaaaaaaaaaaaaaaaaaaaaaaaaaaaaaaaaaaaaaaaaaaaaaaaaaaaaaaaaa1111,yummy,ke8xaqobjtadzbyblpx4ucx383d1t9e2ljmv3dgty30o9lbb8sugxyy6wsp0jeb0,fsparxlb,,,02,,,,5901,2021-09-04 19: 50:58,10000,2000102,,,선유,,,01
208,1111111111111111111111111111111111111111111111111111111111111111111111111111111111111111,aaaaaaaaaaaaaaaaaaaaaaaaaaaaaaaaaaaaaaaaaaaaaaaaaaaaaaaaaaaa1111,yummy,d2rah4uitwhjtdw6brmktbmpw1mzdauyn0a06ae7er6k9wvym8bq6s50o26deasg,clpbexbj,,,02,,,,5202,2021-09-07 14: 01:37,10400,1989702,,,혜또취,,,01
209,1111111111111111111111111111111111111111111111111111111111111111111111111111111111111111,aaaaaaaaaaaaaaaaaaaaaaaaaaaaaaaaaaaaaaaaaaaaaaaaaaaaaaaaaaaa1111,yummy,,,신한,110-63-123456,02,,2000000.0,10000.0,5102,2021-09-08 13: 25:04,10000,1999702,,,***6391 염*진,,,01
210,1111111111111111111111111111111111111111111111111111111111111111111111111111111111111111,aaaaaaaaaaaaaaaaaaaaaaaaaaaaaaaaaaaaaaaaaaaaaaaaaaaaaaaaaaaa1111,yummy,bm2v1gvwx6y8563qec43j0gzwc7k99bwo7iwb69auztb1akcmmqdovm3mj17psmz,gdehvbxh,,,02,,,,5202,2021-09-08 13: 25:04,16000,1983702,,,이서희,,,01
211,1111111111111111111111111111111111111111111111111111111111111111111111111111111111111111,aaaaaaaaaaaaaaaaaaaaaaaaaaaaaaaaaaaaaaaaaaaaaaaaaaaaaaaaaaaa1111,yummy,qhnzl9cndlb6diibwfnizyffephx8jj95ihf5pywgnseegmezave034pdusnx21q,sfczmevb,,,02,,,,5901,2021-09-08 16: 57:08,4000,1987702,,,래현,,,01
212,1111111111111111111111111111111111111111111111111111111111111111111111111111111111111111,aaaaaaaaaaaaaaaaaaaaaaaaaaaaaaaaaaaaaaaaaaaaaaaaaaaaaaaaaaaa1111,yummy,qhnzl9cndlb6diibwfnizyffephx8jj95ihf5pywgnseegmezave034pdusnx21q,sfczmevb,,,02,,,,5901,2021-09-08 20:37:42,4900,1992602,,,래현,,,01
213,1111111111111111111111111111111111111111111111111111111111111111111111111111111111111111,aaaaaaaaaaaaaaaaaaaaaaaaaaaaaaaaaaaaaaaaaaaaaaaaaaaaaaaaaaaa1111,yummy,7eduno9xcrrzswjqzf9h2cgwa7ij75nqrbitp6mnzef6na66xdmk4vd171dz8amm,lndnirai,,,02,,,,5901,2021-09-10 16: 26:26,6500,1999102,,,박재홍,,,01
214,1111111111111111111111111111111111111111111111111111111111111111111111111111111111111111,aaaaaaaaaaaaaaaaaaaaaaaaaaaaaaaaaaaaaaaaaaaaaaaaaaaaaaaaaaaa1111,yummy,,,신한,110-63-123456,02,,2000000.0,10000.0,5102,2021-09-14 13: 35:50,10000,2009102,,,***6391 염*진,,,01
215,1111111111111111111111111111111111111111111111111111111111111111111111111111111111111111,aaaaaaaaaaaaaaaaaaaaaaaaaaaaaaaaaaaaaaaaaaaaaaaaaaaaaaaaaaaa1111,yummy,ieklfha4ebs2d4w6sl0ftwe1nfcy32f7z623jfuy2yrc1zq64fs019xkkdlirnvj,kwwjbkho,,,02,,,,5202,2021-09-14 13: 35:50,22450,1986652,,,서뉴,,,01
216,1111111111111111111111111111111111111111111111111111111111111111111111111111111111111111,aaaaaaaaaaaaaaaaaaaaaaaaaaaaaaaaaaaaaaaaaaaaaaaaaaaaaaaaaaaa1111,yummy,,,신한,110-63-123456,02,,2000000.0,10000.0,5102,2021-09-14 13: 46:23,10000,1996652,,,***6391 염*진,,,01
217,1111111111111111111111111111111111111111111111111111111111111111111111111111111111111111,aaaaaaaaaaaaaaaaaaaaaaaaaaaaaaaaaaaaaaaaaaaaaaaaaaaaaaaaaaaa1111,yummy,14dai49meyzde9cuun62b7db5dd9800b74p0acoysgd4o5wqrkrfx9d1efk2m996,mhqwtwtb,,,02,,,,5202,2021-09-14 13: 46:23,8517,1988135,,,매미년,,,01
218,1111111111111111111111111111111111111111111111111111111111111111111111111111111111111111,aaaaaaaaaaaaaaaaaaaaaaaaaaaaaaaaaaaaaaaaaaaaaaaaaaaaaaaaaaaa1111,yummy,,,신한,110-63-123456,02,,2000000.0,10000.0,5102,2021-09-15 14: 09:19,10000,1998135,,,***6391 염*진,,,01
219,1111111111111111111111111111111111111111111111111111111111111111111111111111111111111111,aaaaaaaaaaaaaaaaaaaaaaaaaaaaaaaaaaaaaaaaaaaaaaaaaaaaaaaaaaaa1111,yummy,d2rah4uitwhjtdw6brmktbmpw1mzdauyn0a06ae7er6k9wvym8bq6s50o26deasg,clpbexbj,,,02,,,,5202,2021-09-15 14: 09:19,11000,1987135,,,혜또취,,,01
220,1111111111111111111111111111111111111111111111111111111111111111111111111111111111111111,aaaaaaaaaaaaaaaaaaaaaaaaaaaaaaaaaaaaaaaaaaaaaaaaaaaaaaaaaaaa1111,yummy,,,신한,110-63-123456,02,,2000000.0,20000.0,5102,2021-09-17 14: 00:49,20000,2007135,,,***6391 염*진,,,01
221,1111111111111111111111111111111111111111111111111111111111111111111111111111111111111111,aaaaaaaaaaaaaaaaaaaaaaaaaaaaaaaaaaaaaaaaaaaaaaaaaaaaaaaaaaaa1111,yummy,cde73umdtxx2ch3i6xkutipatxgugcsx5mzzew8z8wfc1js0gnq6z1ywm2meji8a,qzptchfv,,,02,,,,5202,2021-09-17 14: 00:49,20000,1987135,,,이지똥,,,01
222,1111111111111111111111111111111111111111111111111111111111111111111111111111111111111111,aaaaaaaaaaaaaaaaaaaaaaaaaaaaaaaaaaaaaaaaaaaaaaaaaaaaaaaaaaaa1111,yummy,,,,,02,,,,5501,2021-09-20 17: 09:36,1000,1986135,,,일일권(1시간),,B1,01
223,1111111111111111111111111111111111111111111111111111111111111111111111111111111111111111,aaaaaaaaaaaaaaaaaaaaaaaaaaaaaaaaaaaaaaaaaaaaaaaaaaaaaaaaaaaa1111,yummy,,,신한,110-63-123456,02,,2000000.0,30000.0,5102,2021-09-22 15: 27:57,30000,2016135,,,***6391 염*진,,,01
224,1111111111111111111111111111111111111111111111111111111111111111111111111111111111111111,aaaaaaaaaaaaaaaaaaaaaaaaaaaaaaaaaaaaaaaaaaaaaaaaaaaaaaaaaaaa1111,yummy,rgc8mrxp8924yf7yx41172sylofbrre6r9e7hmqszxtw2q216tb3m7j9fnlz720p,cnpgvjqf,,,02,,,,5201,2021-09-22 15: 27:57,28000,1988135,우리,110-63-123456,***2004 오*름,,,01
225,1111111111111111111111111111111111111111111111111111111111111111111111111111111111111111,aaaaaaaaaaaaaaaaaaaaaaaaaaaaaaaaaaaaaaaaaaaaaaaaaaaaaaaaaaaa1111,yummy,qhnzl9cndlb6diibwfnizyffephx8jj95ihf5pywgnseegmezave034pdusnx21q,sfczmevb,,,02,,,,5901,2021-09-22 21: 52:54,7000,1995135,,,래현,,,01
226,1111111111111111111111111111111111111111111111111111111111111111111111111111111111111111,aaaaaaaaaaaaaaaaaaaaaaaaaaaaaaaaaaaaaaaaaaaaaaaaaaaaaaaaaaaa1111,yummy,,,신한,110-63-123456,02,,2000000.0,20000.0,5102,2021-09-25 16: 50:17,20000,2015135,,,***6391 염*진,,,01
227,1111111111111111111111111111111111111111111111111111111111111111111111111111111111111111,aaaaaaaaaaaaaaaaaaaaaaaaaaaaaaaaaaaaaaaaaaaaaaaaaaaaaaaaaaaa1111,yummy,d2rah4uitwhjtdw6brmktbmpw1mzdauyn0a06ae7er6k9wvym8bq6s50o26deasg,clpbexbj,,,02,,,,5202,2021-09-25 16: 50:17,27000,1988135,,,혜또취,,,01
228,1111111111111111111111111111111111111111111111111111111111111111111111111111111111111111,aaaaaaaaaaaaaaaaaaaaaaaaaaaaaaaaaaaaaaaaaaaaaaaaaaaaaaaaaaaa1111,yummy,,,신한,110-63-123456,02,,2000000.0,20000.0,5102,2021-09-27 00:39:55,20000,2008135,,,***6391 염*진,,,01
229,1111111111111111111111111111111111111111111111111111111111111111111111111111111111111111,aaaaaaaaaaaaaaaaaaaaaaaaaaaaaaaaaaaaaaaaaaaaaaaaaaaaaaaaaaaa1111,yummy,cde73umdtxx2ch3i6xkutipatxgugcsx5mzzew8z8wfc1js0gnq6z1ywm2meji8a,qzptchfv,,,02,,,,5202,2021-09-27 00:39:55,21000,1987135,,,이지똥,,,01
230,1111111111111111111111111111111111111111111111111111111111111111111111111111111111111111,aaaaaaaaaaaaaaaaaaaaaaaaaaaaaaaaaaaaaaaaaaaaaaaaaaaaaaaaaaaa1111,yummy,,,신한,110-63-123456,02,,2000000.0,10000.0,5102,2021-09-27 09:53:06,10000,1997135,,,***6391 염*진,,,01
231,1111111111111111111111111111111111111111111111111111111111111111111111111111111111111111,aaaaaaaaaaaaaaaaaaaaaaaaaaaaaaaaaaaaaaaaaaaaaaaaaaaaaaaaaaaa1111,yummy,d2rah4uitwhjtdw6brmktbmpw1mzdauyn0a06ae7er6k9wvym8bq6s50o26deasg,clpbexbj,,,02,,,,5202,2021-09-27 09:53:06,5700,1991435,,,혜또취,,,01
232,1111111111111111111111111111111111111111111111111111111111111111111111111111111111111111,aaaaaaaaaaaaaaaaaaaaaaaaaaaaaaaaaaaaaaaaaaaaaaaaaaaaaaaaaaaa1111,yummy,qhnzl9cndlb6diibwfnizyffephx8jj95ihf5pywgnseegmezave034pdusnx21q,sfczmevb,,,02,,,,5901,2021-09-27 18: 31:55,4700,1996135,,,래현,,,01
233,1111111111111111111111111111111111111111111111111111111111111111111111111111111111111111,aaaaaaaaaaaaaaaaaaaaaaaaaaaaaaaaaaaaaaaaaaaaaaaaaaaaaaaaaaaa1111,yummy,,,신한,110-63-123456,02,,2000000.0,10000.0,5102,2021-10-03 01: 19:24,10000,2006135,,,***6391 염*진,,,01
234,1111111111111111111111111111111111111111111111111111111111111111111111111111111111111111,aaaaaaaaaaaaaaaaaaaaaaaaaaaaaaaaaaaaaaaaaaaaaaaaaaaaaaaaaaaa1111,yummy,cde73umdtxx2ch3i6xkutipatxgugcsx5mzzew8z8wfc1js0gnq6z1ywm2meji8a,qzptchfv,,,02,,,,5202,2021-10-03 01: 19:24,15000,1991135,,,이지똥,,,01
235,1111111111111111111111111111111111111111111111111111111111111111111111111111111111111111,aaaaaaaaaaaaaaaaaaaaaaaaaaaaaaaaaaaaaaaaaaaaaaaaaaaaaaaaaaaa1111,yummy,,,신한,110-63-123456,02,,2000000.0,20000.0,5102,2021-10-03 02: 28:25,20000,2011135,,,***6391 염*진,,,01
236,1111111111111111111111111111111111111111111111111111111111111111111111111111111111111111,aaaaaaaaaaaaaaaaaaaaaaaaaaaaaaaaaaaaaaaaaaaaaaaaaaaaaaaaaaaa1111,yummy,db38ciertmkegf2j6ft6bt7new8bo1iqns0h0g886otdb8gx3j0yn3mcpeay0u3k,uahgxmnx,,,02,,,,5201,2021-10-03 02: 28:25,19500,1991635,카카 오뱅 크,110-63-123456,***0537 최*수,,,01
237,1111111111111111111111111111111111111111111111111111111111111111111111111111111111111111,aaaaaaaaaaaaaaaaaaaaaaaaaaaaaaaaaaaaaaaaaaaaaaaaaaaaaaaaaaaa1111,yummy,kx3dmr7ebjh3v3prxsa7948gztchksxvm1tr6fuib64b9m7l329o58lgcw4yqso9,ccdohbtd,,,02,,,,5901,2021-10-03 19: 27:56,33948,2025583,,,다예,,,01
238,1111111111111111111111111111111111111111111111111111111111111111111111111111111111111111,aaaaaaaaaaaaaaaaaaaaaaaaaaaaaaaaaaaaaaaaaaaaaaaaaaaaaaaaaaaa1111,yummy,xd09kdwwbnqnq82zrtnn6gtwdx6ods9mrgob4hz86qdfyvxqaisv2q2h5zfo0hur,mofnkfqw,,,02,,,,5901,2021-10-03 19: 28:07,33948,2059531,,,조언실,,,01
239,1111111111111111111111111111111111111111111111111111111111111111111111111111111111111111,aaaaaaaaaaaaaaaaaaaaaaaaaaaaaaaaaaaaaaaaaaaaaaaaaaaaaaaaaaaa1111,yummy,8wvmeg589acp0jdf9xyn6xq9j3xv06751b50f2hxae9nfi4wqofk9u2g9u3u1xq4,cymeoflb,,,02,,,,5901,2021-10-03 19: 28:19,33948,2093479,,,김서원,,,01
240,1111111111111111111111111111111111111111111111111111111111111111111111111111111111111111,aaaaaaaaaaaaaaaaaaaaaaaaaaaaaaaaaaaaaaaaaaaaaaaaaaaaaaaaaaaa1111,yummy,0ty9m5c2yrwgtnb91dkuarj16ncgz9j6pzla59rkkh0brm0544ny2gukdew1q2sm,yfhtmbjr,,,02,,,,5201,2021-10-04 07: 22:40,18000,2075479,우리,110-63-123456,***9112 박*우,,,01
241,1111111111111111111111111111111111111111111111111111111111111111111111111111111111111111,aaaaaaaaaaaaaaaaaaaaaaaaaaaaaaaaaaaaaaaaaaaaaaaaaaaaaaaaaaaa1111,yummy,19ihdkwo9sncsghwp1gdo36xqzf8ntxpe5c8iw7it3iovw9wf096uhzfzmii04ww,buuksirl,,,02,,,,5901,2021-10-04 13: 15:51,33948,2109427,,,오지현,,,01
242,1111111111111111111111111111111111111111111111111111111111111111111111111111111111111111,aaaaaaaaaaaaaaaaaaaaaaaaaaaaaaaaaaaaaaaaaaaaaaaaaaaaaaaaaaaa1111,yummy,,,,,02,,,,5501,2021-10-04 13: 52:30,23900,2085527,,,"[단독/선물포장] ""지켜줄 게 머릿결"" 헤어 BEST 3 종 선물세트(미니어처&
헤어캡 증정)",,A1,01
243,1111111111111111111111111111111111111111111111111111111111111111111111111111111111111111,aaaaaaaaaaaaaaaaaaaaaaaaaaaaaaaaaaaaaaaaaaaaaaaaaaaaaaaaaaaa1111,yummy,vpntzehvs95z6rn1q2s8a1116sukip8c7g5bm23qdujfx9p9yro1yms5w6ozayqo,jbwbesja,,,02,,,,5901,2021-10-06 22: 01:31,64000,2149527,,,혜원,,,01
244,1111111111111111111111111111111111111111111111111111111111111111111111111111111111111111,aaaaaaaaaaaaaaaaaaaaaaaaaaaaaaaaaaaaaaaaaaaaaaaaaaaaaaaaaaaa1111,yummy,cde73umdtxx2ch3i6xkutipatxgugcsx5mzzew8z8wfc1js0gnq6z1ywm2meji8a,qzptchfv,,,02,,,,5202,2021-10-06 22: 03:33,15000,2134527,,,이지똥,,,01
245,1111111111111111111111111111111111111111111111111111111111111111111111111111111111111111,aaaaaaaaaaaaaaaaaaaaaaaaaaaaaaaaaaaaaaaaaaaaaaaaaaaaaaaaaaaa1111,yummy,,,,,02,,,,5501,2021-10-07 15: 50:45,5400,2129127,,,롯데)더블비얀코 외 2개,,H1,01
246,1111111111111111111111111111111111111111111111111111111111111111111111111111111111111111,aaaaaaaaaaaaaaaaaaaaaaaaaaaaaaaaaaaaaaaaaaaaaaaaaaaaaaaaaaaa1111,yummy,,,,,02,,,,5501,2021-10-11 12: 14:43,22000,2107127,,,"[선물포장] '촉촉 힐링' 아비노 바디워시&로션 세트(+파우치 증정) (톡
별)",,L1,01
247,1111111111111111111111111111111111111111111111111111111111111111111111111111111111111111,aaaaaaaaaaaaaaaaaaaaaaaaaaaaaaaaaaaaaaaaaaaaaaaaaaaaaaaaaaaa1111,yummy,,,,,02,,,,5501,2021-10-12 11: 09:26,7300,2099827,,,이탈리안 비엠티외 1건,,A1,01
248,1111111111111111111111111111111111111111111111111111111111111111111111111111111111111111,aaaaaaaaaaaaaaaaaaaaaaaaaaaaaaaaaaaaaaaaaaaaaaaaaaaaaaaaaaaa1111,yummy,vpntzehvs95z6rn1q2s8a1116sukip8c7g5bm23qdujfx9p9yro1yms5w6ozayqo,jbwbesja,,,02,,,,5901,2021-10-12 13: 03:12,8300,2108127,,,혜원,,,01
249,1111111111111111111111111111111111111111111111111111111111111111111111111111111111111111,aaaaaaaaaaaaaaaaaaaaaaaaaaaaaaaaaaaaaaaaaaaaaaaaaaaaaaaaaaaa1111,yummy,d2rah4uitwhjtdw6brmktbmpw1mzdauyn0a06ae7er6k9wvym8bq6s50o26deasg,clpbexbj,,,02,,,,5202,2021-10-14 13: 05:15,42500,2065627,,,혜또취,,,01
250,1111111111111111111111111111111111111111111111111111111111111111111111111111111111111111,aaaaaaaaaaaaaaaaaaaaaaaaaaaaaaaaaaaaaaaaaaaaaaaaaaaaaaaaaaaa1111,yummy,db0vt0hrlblp90v94jcaknnu6p7zg71pc17ij91scjl78nodie69kt45fqmxuj4g,thrbpuku,,,02,,,,5202,2021-10-15 11: 52:28,5100,2060527,,,닉컴퍼니_최승언,,,01
251,1111111111111111111111111111111111111111111111111111111111111111111111111111111111111111,aaaaaaaaaaaaaaaaaaaaaaaaaaaaaaaaaaaaaaaaaaaaaaaaaaaaaaaaaaaa1111,yummy,vpntzehvs95z6rn1q2s8a1116sukip8c7g5bm23qdujfx9p9yro1yms5w6ozayqo,jbwbesja,,,02,,,,5901,2021-10-18 13: 30:24,9229,2069756,,,혜원,,,01
252,1111111111111111111111111111111111111111111111111111111111111111111111111111111111111111,aaaaaaaaaaaaaaaaaaaaaaaaaaaaaaaaaaaaaaaaaaaaaaaaaaaaaaaaaaaa1111,yummy,vd96dpefnzsfolkppxqr7pxoi67rdvl26z03g5pjz7p148co6qppo3vzml7a9u2v,oskqlmpu,,,02,,,,5201,2021-10-20 13: 12:43,17000,2052756,신한,110-63-123456,***7642 임*빈,,,01
253,1111111111111111111111111111111111111111111111111111111111111111111111111111111111111111,aaaaaaaaaaaaaaaaaaaaaaaaaaaaaaaaaaaaaaaaaaaaaaaaaaaaaaaaaaaa1111,yummy,wakzlp5d8o4ez5gzt8vorz4z0gbfwcrzo5969ejp445fh4dq17p7nhyeamli56np,zotwhrws,,,02,,,,5202,2021-10-20 13: 18:05,5200,2047556,,,정통14소영선,,,01
254,1111111111111111111111111111111111111111111111111111111111111111111111111111111111111111,aaaaaaaaaaaaaaaaaaaaaaaaaaaaaaaaaaaaaaaaaaaaaaaaaaaaaaaaaaaa1111,yummy,d2rah4uitwhjtdw6brmktbmpw1mzdauyn0a06ae7er6k9wvym8bq6s50o26deasg,clpbexbj,,,02,,,,5202,2021-10-21 12: 50:32,62500,1985056,,,혜또취,,,01
255,1111111111111111111111111111111111111111111111111111111111111111111111111111111111111111,aaaaaaaaaaaaaaaaaaaaaaaaaaaaaaaaaaaaaaaaaaaaaaaaaaaaaaaaaaaa1111,yummy,,,신한,110-63-123456,02,,2000000.0,20000.0,5102,2021-10-21 13: 24:56,20000,2005056,,,***6391 염*진,,,01
256,1111111111111111111111111111111111111111111111111111111111111111111111111111111111111111,aaaaaaaaaaaaaaaaaaaaaaaaaaaaaaaaaaaaaaaaaaaaaaaaaaaaaaaaaaaa1111,yummy,6brvp1v8vhwmqjz3y5ei6my1tjco12oq6hf5rbk187c4kgalajsmom76z3xx0v9n,loveppvj,,,02,,,,5201,2021-10-21 13: 24:56,16000,1989056,국민,110-63-123456,***9478 이*새,,,01
257,1111111111111111111111111111111111111111111111111111111111111111111111111111111111111111,aaaaaaaaaaaaaaaaaaaaaaaaaaaaaaaaaaaaaaaaaaaaaaaaaaaaaaaaaaaa1111,yummy,l0ttmt8cexn3t4w6qwwlylqyago2y8p2gywcihd8ieyfnjgt64hhqifuodvhc4vd,epoyhfxm,,,02,,,,5202,2021-10-22 13: 31:24,2500,1986556,,,닉컴퍼니_박경훈,,,01
258,1111111111111111111111111111111111111111111111111111111111111111111111111111111111111111,aaaaaaaaaaaaaaaaaaaaaaaaaaaaaaaaaaaaaaaaaaaaaaaaaaaaaaaaaaaa1111,yummy,reohjbuea244yvrh08dxj4v9etgyji6sxoj8deqme56p2vn2ajn0ljwzayeumu3k,lvzhyvjg,,,02,,,,5901,2021-10-24 19: 31:27,10000,1996556,,,민서정,,,01
259,1111111111111111111111111111111111111111111111111111111111111111111111111111111111111111,aaaaaaaaaaaaaaaaaaaaaaaaaaaaaaaaaaaaaaaaaaaaaaaaaaaaaaaaaaaa1111,yummy,,,신한,110-63-123456,02,,2000000.0,10000.0,5102,2021-10-25 13: 15:11,10000,2006556,,,***6391 염*진,,,01
260,1111111111111111111111111111111111111111111111111111111111111111111111111111111111111111,aaaaaaaaaaaaaaaaaaaaaaaaaaaaaaaaaaaaaaaaaaaaaaaaaaaaaaaaaaaa1111,yummy,3r8gmzomtgj5tnwmdpd89glc1lg5oy2ots09rger49qyfs8x1aio2sgic9obt6kp,qluzxwng,,,02,,,,5201,2021-10-25 13: 15:11,18000,1988556,대구,110-63-123456,***3251 김*영,,,01
261,1111111111111111111111111111111111111111111111111111111111111111111111111111111111111111,aaaaaaaaaaaaaaaaaaaaaaaaaaaaaaaaaaaaaaaaaaaaaaaaaaaaaaaaaaaa1111,yummy,,,신한,110-63-123456,02,,2000000.0,20201.0,5102,2021-10-25 18: 02:29,20201,2008757,,,***6391 염*진,,,01
262,1111111111111111111111111111111111111111111111111111111111111111111111111111111111111111,aaaaaaaaaaaaaaaaaaaaaaaaaaaaaaaaaaaaaaaaaaaaaaaaaaaaaaaaaaaa1111,yummy,,,,,02,,,,5501,2021-10-25 18: 02:29,27000,1981757,,,마이넘버원3(배달가능),,L1,01
263,1111111111111111111111111111111111111111111111111111111111111111111111111111111111111111,aaaaaaaaaaaaaaaaaaaaaaaaaaaaaaaaaaaaaaaaaaaaaaaaaaaaaaaaaaaa1111,yummy,,,신한,110-63-123456,02,,2000000.0,29000.0,5102,2021-10-25 18: 13:05,29000,2010757,,,***6391 염*진,,,01
264,1111111111111111111111111111111111111111111111111111111111111111111111111111111111111111,aaaaaaaaaaaaaaaaaaaaaaaaaaaaaaaaaaaaaaaaaaaaaaaaaaaaaaaaaaaa1111,yummy,,,,,02,,,,5501,2021-10-25 18: 13:05,29000,1981757,,,우유가득 생크림케이크,,D1,01
265,1111111111111111111111111111111111111111111111111111111111111111111111111111111111111111,aaaaaaaaaaaaaaaaaaaaaaaaaaaaaaaaaaaaaaaaaaaaaaaaaaaaaaaaaaaa1111,yummy,,,,,02,,,,5502,2021-10-25 18: 14:05,29000,2010757,,,우유가득 생크림케이크,,D1,01
266,1111111111111111111111111111111111111111111111111111111111111111111111111111111111111111,aaaaaaaaaaaaaaaaaaaaaaaaaaaaaaaaaaaaaaaaaaaaaaaaaaaaaaaaaaaa1111,yummy,,,,,02,,,,5501,2021-10-25 18: 28:17,29000,1981757,,,우유가득 생크림케이크,,D1,01
267,1111111111111111111111111111111111111111111111111111111111111111111111111111111111111111,aaaaaaaaaaaaaaaaaaaaaaaaaaaaaaaaaaaaaaaaaaaaaaaaaaaaaaaaaaaa1111,yummy,4wgovf4yhavrtpf48fyvcm6kpyxzg55ihrjxz11ni3844u0mp6y9dev5es4yn34z,sbvgbfsz,,,02,,,,5901,2021-10-29 11: 19:57,8425,1990182,,,유재석,,,01
268,1111111111111111111111111111111111111111111111111111111111111111111111111111111111111111,aaaaaaaaaaaaaaaaaaaaaaaaaaaaaaaaaaaaaaaaaaaaaaaaaaaaaaaaaaaa1111,yummy,,,신한,110-63-123456,02,,2000000.0,20000.0,5102,2021-10-31 09: 40:47,20000,2010182,,,***6391 염*진,,,01
269,1111111111111111111111111111111111111111111111111111111111111111111111111111111111111111,aaaaaaaaaaaaaaaaaaaaaaaaaaaaaaaaaaaaaaaaaaaaaaaaaaaaaaaaaaaa1111,yummy,14dai49meyzde9cuun62b7db5dd9800b74p0acoysgd4o5wqrkrfx9d1efk2m996,mhqwtwtb,,,02,,,,5202,2021-10-31 09: 40:47,21260,1988922,,,매미년,,,01
270,1111111111111111111111111111111111111111111111111111111111111111111111111111111111111111,aaaaaaaaaaaaaaaaaaaaaaaaaaaaaaaaaaaaaaaaaaaaaaaaaaaaaaaaaaaa1111,yummy,,,,,02,,,,5501,2021-11-01 08: 18:05,3900,1985022,,,My 구독 정기결제,,G1,01
271,1111111111111111111111111111111111111111111111111111111111111111111111111111111111111111,aaaaaaaaaaaaaaaaaaaaaaaaaaaaaaaaaaaaaaaaaaaaaaaaaaaaaaaaaaaa1111,yummy,,,신한,110-63-123456,02,,2000000.0,10000.0,5102,2021-11-01 12: 27:38,10000,1995022,,,***6391 염*진,,,01
272,1111111111111111111111111111111111111111111111111111111111111111111111111111111111111111,aaaaaaaaaaaaaaaaaaaaaaaaaaaaaaaaaaaaaaaaaaaaaaaaaaaaaaaaaaaa1111,yummy,khnrar5zhqxgwls8233lrw8jb2fi0gj3930bs099x1ec5iju6izusu1rzgzgzqso,qteftkun,,,02,,,,5202,2021-11-01 12: 27:38,8000,1987022,,,닉컴퍼니_박재홍 실장님,,,01
273,1111111111111111111111111111111111111111111111111111111111111111111111111111111111111111,aaaaaaaaaaaaaaaaaaaaaaaaaaaaaaaaaaaaaaaaaaaaaaaaaaaaaaaaaaaa1111,yummy,,,신한,110-63-123456,02,,2000000.0,30000.0,5102,2021-11-02 12: 56:19,30000,2017022,,,***6391 염*진,,,01
274,1111111111111111111111111111111111111111111111111111111111111111111111111111111111111111,aaaaaaaaaaaaaaaaaaaaaaaaaaaaaaaaaaaaaaaaaaaaaaaaaaaaaaaaaaaa1111,yummy,d2rah4uitwhjtdw6brmktbmpw1mzdauyn0a06ae7er6k9wvym8bq6s50o26deasg,clpbexbj,,,02,,,,5202,2021-11-02 12: 56:19,26300,1990722,,,혜또취,,,01
275,1111111111111111111111111111111111111111111111111111111111111111111111111111111111111111,aaaaaaaaaaaaaaaaaaaaaaaaaaaaaaaaaaaaaaaaaaaaaaaaaaaaaaaaaaaa1111,yummy,,,신한,110-63-123456,02,,2000000.0,19135.0,5102,2021-11-03 11: 49:28,19135,2009857,,,***6391 염*진,,,01
276,1111111111111111111111111111111111111111111111111111111111111111111111111111111111111111,aaaaaaaaaaaaaaaaaaaaaaaaaaaaaaaaaaaaaaaaaaaaaaaaaaaaaaaaaaaa1111,yummy,,,,,02,,,,5501,2021-11-03 11: 49:28,28100,1981757,,,로티세리 치킨외 4건,,I1,01
277,1111111111111111111111111111111111111111111111111111111111111111111111111111111111111111,aaaaaaaaaaaaaaaaaaaaaaaaaaaaaaaaaaaaaaaaaaaaaaaaaaaaaaaaaaaa1111,yummy,5nomphxjetzqivf3q22henyb6o85ezzg5bcygimdc2lgyqzfo391gdl8ga84rlku,eghabrmp,,,02,,,,5901,2021-11-03 12: 16:33,9100,1990857,,,Byounghoon Paul Lee,,,01
278,1111111111111111111111111111111111111111111111111111111111111111111111111111111111111111,aaaaaaaaaaaaaaaaaaaaaaaaaaaaaaaaaaaaaaaaaaaaaaaaaaaaaaaaaaaa1111,yummy,vsgwwexqucg7cvk5cfebo5cnze0og91b1x94676oe422of7m4rn919o83cwfrpvq,pngdjtne,,,02,,,,5901,2021-11-03 12: 16:38,8000,1998857,,,김윤호,,,01
279,1111111111111111111111111111111111111111111111111111111111111111111111111111111111111111,aaaaaaaaaaaaaaaaaaaaaaaaaaaaaaaaaaaaaaaaaaaaaaaaaaaaaaaaaaaa1111,yummy,k5mc2zukm5hkbv2al9fcalp7v90tffv9yt26ya03ko5xh2fux0y6kbfxtru69bbw,rhkdhabl,,,02,,,,5901,2021-11-03 13: 42:10,8500,2007357,,,승언,,,01
280,1111111111111111111111111111111111111111111111111111111111111111111111111111111111111111,aaaaaaaaaaaaaaaaaaaaaaaaaaaaaaaaaaaaaaaaaaaaaaaaaaaaaaaaaaaa1111,yummy,vpntzehvs95z6rn1q2s8a1116sukip8c7g5bm23qdujfx9p9yro1yms5w6ozayqo,jbwbesja,,,02,,,,5901,2021-11-04 19: 42:33,25000,2032357,,,혜원,,,01
281,1111111111111111111111111111111111111111111111111111111111111111111111111111111111111111,aaaaaaaaaaaaaaaaaaaaaaaaaaaaaaaaaaaaaaaaaaaaaaaaaaaaaaaaaaaa1111,yummy,4wgovf4yhavrtpf48fyvcm6kpyxzg55ihrjxz11ni3844u0mp6y9dev5es4yn34z,sbvgbfsz,,,02,,,,5901,2021-11-06 18: 40:17,15450,2047807,,,유재석,,,01
282,1111111111111111111111111111111111111111111111111111111111111111111111111111111111111111,aaaaaaaaaaaaaaaaaaaaaaaaaaaaaaaaaaaaaaaaaaaaaaaaaaaaaaaaaaaa1111,yummy,,,,,02,,,,5501,2021-11-07 04: 06:17,7200,2040607,,,1955버거 세트,,I1,01
283,1111111111111111111111111111111111111111111111111111111111111111111111111111111111111111,aaaaaaaaaaaaaaaaaaaaaaaaaaaaaaaaaaaaaaaaaaaaaaaaaaaaaaaaaaaa1111,yummy,,,,,02,,,,5501,2021-11-07 04: 07:16,8200,2032407,,,파인트 아이스크림,,D1,01
284,1111111111111111111111111111111111111111111111111111111111111111111111111111111111111111,aaaaaaaaaaaaaaaaaaaaaaaaaaaaaaaaaaaaaaaaaaaaaaaaaaaaaaaaaaaa1111,yummy,,,,,02,,,,5501,2021-11-10 00: 51:27,33000,1999407,,,[단독] 사봉 베스트 3종 미니 선물세트 (톡별),,A1,01
285,1111111111111111111111111111111111111111111111111111111111111111111111111111111111111111,aaaaaaaaaaaaaaaaaaaaaaaaaaaaaaaaaaaaaaaaaaaaaaaaaaaaaaaaaaaa1111,yummy,vpntzehvs95z6rn1q2s8a1116sukip8c7g5bm23qdujfx9p9yro1yms5w6ozayqo,jbwbesja,,,02,,,,5901,2021-11-10 17: 06:27,47074,2046481,,,혜원,,,01
286,1111111111111111111111111111111111111111111111111111111111111111111111111111111111111111,aaaaaaaaaaaaaaaaaaaaaaaaaaaaaaaaaaaaaaaaaaaaaaaaaaaaaaaaaaaa1111,yummy,d2rah4uitwhjtdw6brmktbmpw1mzdauyn0a06ae7er6k9wvym8bq6s50o26deasg,clpbexbj,,,02,,,,5202,2021-11-10 17: 07:22,23532,2022949,,,혜또취,,,01
287,1111111111111111111111111111111111111111111111111111111111111111111111111111111111111111,aaaaaaaaaaaaaaaaaaaaaaaaaaaaaaaaaaaaaaaaaaaaaaaaaaaaaaaaaaaa1111,yummy,db0vt0hrlblp90v94jcaknnu6p7zg71pc17ij91scjl78nodie69kt45fqmxuj4g,thrbpuku,,,02,,,,5202,2021-11-11 12: 14:53,20000,2002949,,,닉컴퍼니_최승언,,,01
288,1111111111111111111111111111111111111111111111111111111111111111111111111111111111111111,aaaaaaaaaaaaaaaaaaaaaaaaaaaaaaaaaaaaaaaaaaaaaaaaaaaaaaaaaaaa1111,yummy,,,신한,110-63-123456,02,,2000000.0,10000.0,5102,2021-11-14 13: 26:34,10000,2012949,,,***6391 염*진,,,01
289,1111111111111111111111111111111111111111111111111111111111111111111111111111111111111111,aaaaaaaaaaaaaaaaaaaaaaaaaaaaaaaaaaaaaaaaaaaaaaaaaaaaaaaaaaaa1111,yummy,cde73umdtxx2ch3i6xkutipatxgugcsx5mzzew8z8wfc1js0gnq6z1ywm2meji8a,qzptchfv,,,02,,,,5202,2021-11-14 13: 26:34,29000,1983949,,,이지똥,,,01
290,1111111111111111111111111111111111111111111111111111111111111111111111111111111111111111,aaaaaaaaaaaaaaaaaaaaaaaaaaaaaaaaaaaaaaaaaaaaaaaaaaaaaaaaaaaa1111,yummy,,,신한,110-63-123456,02,,2000000.0,30000.0,5102,2021-11-15 11: 39:03,30000,2013949,,,***6391 염*진,,,01
291,1111111111111111111111111111111111111111111111111111111111111111111111111111111111111111,aaaaaaaaaaaaaaaaaaaaaaaaaaaaaaaaaaaaaaaaaaaaaaaaaaaaaaaaaaaa1111,yummy,14dai49meyzde9cuun62b7db5dd9800b74p0acoysgd4o5wqrkrfx9d1efk2m996,mhqwtwtb,,,02,,,,5202,2021-11-15 11: 39:03,24750,1989199,,,매미년,,,01
292,1111111111111111111111111111111111111111111111111111111111111111111111111111111111111111,aaaaaaaaaaaaaaaaaaaaaaaaaaaaaaaaaaaaaaaaaaaaaaaaaaaaaaaaaaaa1111,yummy,,,신한,110-63-123456,02,,2000000.0,10000.0,5102,2021-11-17 12: 16:46,10000,1999199,,,***6391 염*진,,,01
293,1111111111111111111111111111111111111111111111111111111111111111111111111111111111111111,aaaaaaaaaaaaaaaaaaaaaaaaaaaaaaaaaaaaaaaaaaaaaaaaaaaaaaaaaaaa1111,yummy,db0vt0hrlblp90v94jcaknnu6p7zg71pc17ij91scjl78nodie69kt45fqmxuj4g,thrbpuku,,,02,,,,5202,2021-11-17 12: 16:46,9000,1990199,,,닉컴퍼니_최승언,,,01
294,1111111111111111111111111111111111111111111111111111111111111111111111111111111111111111,aaaaaaaaaaaaaaaaaaaaaaaaaaaaaaaaaaaaaaaaaaaaaaaaaaaaaaaaaaaa1111,yummy,,,신한,110-63-123456,02,,2000000.0,10000.0,5102,2021-11-17 22: 18:46,10000,2000199,,,***6391 염*진,,,01
295,1111111111111111111111111111111111111111111111111111111111111111111111111111111111111111,aaaaaaaaaaaaaaaaaaaaaaaaaaaaaaaaaaaaaaaaaaaaaaaaaaaaaaaaaaaa1111,yummy,cde73umdtxx2ch3i6xkutipatxgugcsx5mzzew8z8wfc1js0gnq6z1ywm2meji8a,qzptchfv,,,02,,,,5202,2021-11-17 22: 18:46,13000,1987199,,,이지똥,,,01
296,1111111111111111111111111111111111111111111111111111111111111111111111111111111111111111,aaaaaaaaaaaaaaaaaaaaaaaaaaaaaaaaaaaaaaaaaaaaaaaaaaaaaaaaaaaa1111,yummy,,,,,02,,,,5502,2021-11-18 07: 02:07,33000,2020199,,,[단독] 사봉 베스트 3종 미니 선물세트 (톡별),,A1,01
297,1111111111111111111111111111111111111111111111111111111111111111111111111111111111111111,aaaaaaaaaaaaaaaaaaaaaaaaaaaaaaaaaaaaaaaaaaaaaaaaaaaaaaaaaaaa1111,yummy,,,신한,110-63-123456,02,,2000000.0,40000.0,5102,2021-11-18 09: 37:02,40000,2060199,,,***6391 염*진,,,01
298,1111111111111111111111111111111111111111111111111111111111111111111111111111111111111111,aaaaaaaaaaaaaaaaaaaaaaaaaaaaaaaaaaaaaaaaaaaaaaaaaaaaaaaaaaaa1111,yummy,xhdmss6aeujx322bnugpy22gqx4ak7voruuzxtij0zid3s86svrvlvg5d7j9vs7l,unvktxbo,,,02,,,,5202,2021-11-18 09: 37:02,72792,1987407,,,멍청오지치즈#,,,01
299,1111111111111111111111111111111111111111111111111111111111111111111111111111111111111111,aaaaaaaaaaaaaaaaaaaaaaaaaaaaaaaaaaaaaaaaaaaaaaaaaaaaaaaaaaaa1111,yummy,,,신한,110-63-123456,02,,2000000.0,20000.0,5102,2021-11-18 09: 39:11,20000,2007407,,,***6391 염*진,,,01
300,1111111111111111111111111111111111111111111111111111111111111111111111111111111111111111,aaaaaaaaaaaaaaaaaaaaaaaaaaaaaaaaaaaaaaaaaaaaaaaaaaaaaaaaaaaa1111,yummy,cde73umdtxx2ch3i6xkutipatxgugcsx5mzzew8z8wfc1js0gnq6z1ywm2meji8a,qzptchfv,,,02,,,,5202,2021-11-18 09: 39:11,20000,1987407,,,이지똥,,,01
301,1111111111111111111111111111111111111111111111111111111111111111111111111111111111111111,aaaaaaaaaaaaaaaaaaaaaaaaaaaaaaaaaaaaaaaaaaaaaaaaaaaaaaaaaaaa1111,yummy,cde73umdtxx2ch3i6xkutipatxgugcsx5mzzew8z8wfc1js0gnq6z1ywm2meji8a,qzptchfv,,,02,,,,5202,2021-11-18 09: 40:02,2500,1984907,,,이지똥,,,01
302,1111111111111111111111111111111111111111111111111111111111111111111111111111111111111111,aaaaaaaaaaaaaaaaaaaaaaaaaaaaaaaaaaaaaaaaaaaaaaaaaaaaaaaaaaaa1111,yummy,,,신한,110-63-123456,02,,2000000.0,29850.0,5102,2021-11-18 09: 42:22,29850,2014757,,,***6391 염*진,,,01
303,1111111111111111111111111111111111111111111111111111111111111111111111111111111111111111,aaaaaaaaaaaaaaaaaaaaaaaaaaaaaaaaaaaaaaaaaaaaaaaaaaaaaaaaaaaa1111,yummy,,,,,02,,,,5501,2021-11-18 09: 42:22,33000,1981757,,,[단독] 사봉 베스트 3종 미니 선물세트 (톡별),,A1,01
304,1111111111111111111111111111111111111111111111111111111111111111111111111111111111111111,aaaaaaaaaaaaaaaaaaaaaaaaaaaaaaaaaaaaaaaaaaaaaaaaaaaaaaaaaaaa1111,yummy,,,신한,110-63-123456,02,,2000000.0,40000.0,5102,2021-11-19 11: 32:01,40000,2021757,,,***6391 염*진,,,01
305,1111111111111111111111111111111111111111111111111111111111111111111111111111111111111111,aaaaaaaaaaaaaaaaaaaaaaaaaaaaaaaaaaaaaaaaaaaaaaaaaaaaaaaaaaaa1111,yummy,14dai49meyzde9cuun62b7db5dd9800b74p0acoysgd4o5wqrkrfx9d1efk2m996,mhqwtwtb,,,02,,,,5202,2021-11-19 11: 32:01,38333,1983424,,,매미년,,,01
306,1111111111111111111111111111111111111111111111111111111111111111111111111111111111111111,aaaaaaaaaaaaaaaaaaaaaaaaaaaaaaaaaaaaaaaaaaaaaaaaaaaaaaaaaaaa1111,yummy,,,신한,110-63-123456,02,,2000000.0,10000.0,5102,2021-11-20 21: 02:33,10000,1993424,,,***6391 염*진,,,01
307,1111111111111111111111111111111111111111111111111111111111111111111111111111111111111111,aaaaaaaaaaaaaaaaaaaaaaaaaaaaaaaaaaaaaaaaaaaaaaaaaaaaaaaaaaaa1111,yummy,14dai49meyzde9cuun62b7db5dd9800b74p0acoysgd4o5wqrkrfx9d1efk2m996,mhqwtwtb,,,02,,,,5202,2021-11-20 21: 02:33,10000,1983424,,,매미년,,,01
308,1111111111111111111111111111111111111111111111111111111111111111111111111111111111111111,aaaaaaaaaaaaaaaaaaaaaaaaaaaaaaaaaaaaaaaaaaaaaaaaaaaaaaaaaaaa1111,yummy,,,신한,110-63-123456,02,,2000000.0,20000.0,5102,2021-11-25 01: 39:50,20000,2003424,,,***6391 염*진,,,01
309,1111111111111111111111111111111111111111111111111111111111111111111111111111111111111111,aaaaaaaaaaaaaaaaaaaaaaaaaaaaaaaaaaaaaaaaaaaaaaaaaaaaaaaaaaaa1111,yummy,x3qd2jq7s405oc1gpd779179sr7re1uno5lsvxuqefdi372tas28zgleh6ekm2rk,nnvcdapt,,,02,,,,5201,2021-11-25 01: 39:50,13000,1990424,하나,110-63-123456,***0707 이*연,,,01
310,1111111111111111111111111111111111111111111111111111111111111111111111111111111111111111,aaaaaaaaaaaaaaaaaaaaaaaaaaaaaaaaaaaaaaaaaaaaaaaaaaaaaaaaaaaa1111,yummy,,,신한,110-63-123456,02,,2000000.0,40000.0,5102,2021-11-26 16: 25:19,40000,2030424,,,***6391 염*진,,,01
311,1111111111111111111111111111111111111111111111111111111111111111111111111111111111111111,aaaaaaaaaaaaaaaaaaaaaaaaaaaaaaaaaaaaaaaaaaaaaaaaaaaaaaaaaaaa1111,yummy,bg1x1qw0osqir290i8886tyb859rgbjp8s68362kx5hx6yf3twzlcp6p6cpwpu2h,cpgfgsxj,,,02,,,,5201,2021-11-26 16: 25:19,43000,1987424,카카 오뱅 크,110-63-123456,***2185 김*숙,,,01
312,1111111111111111111111111111111111111111111111111111111111111111111111111111111111111111,aaaaaaaaaaaaaaaaaaaaaaaaaaaaaaaaaaaaaaaaaaaaaaaaaaaaaaaaaaaa1111,yummy,qhnzl9cndlb6diibwfnizyffephx8jj95ihf5pywgnseegmezave034pdusnx21q,sfczmevb,,,02,,,,5901,2021-11-28 12: 58:41,14000,2001424,,,래현,,,01
313,1111111111111111111111111111111111111111111111111111111111111111111111111111111111111111,aaaaaaaaaaaaaaaaaaaaaaaaaaaaaaaaaaaaaaaaaaaaaaaaaaaaaaaaaaaa1111,yummy,vkwhzjvrl37v5nds8r59oy8kwrzmzz6h2ma01vnjnqvbseg8b2c9k3i94ihepxgk,cnksojif,,,02,,,,5201,2021-11-29 16: 41:04,12000,1989424,카카 오뱅 크,110-63-123456,***7273 이*미,,,01
314,1111111111111111111111111111111111111111111111111111111111111111111111111111111111111111,aaaaaaaaaaaaaaaaaaaaaaaaaaaaaaaaaaaaaaaaaaaaaaaaaaaaaaaaaaaa1111,yummy,k5mc2zukm5hkbv2al9fcalp7v90tffv9yt26ya03ko5xh2fux0y6kbfxtru69bbw,rhkdhabl,,,02,,,,5901,2021-11-30 12: 08:08,7000,1996424,,,승언,,,01
315,1111111111111111111111111111111111111111111111111111111111111111111111111111111111111111,aaaaaaaaaaaaaaaaaaaaaaaaaaaaaaaaaaaaaaaaaaaaaaaaaaaaaaaaaaaa1111,yummy,,,,,02,,,,5501,2021-12-01 09: 15:55,3900,1992524,,,My 구독 - 이모티콘 플 러스,,E1,01
316,1111111111111111111111111111111111111111111111111111111111111111111111111111111111111111,aaaaaaaaaaaaaaaaaaaaaaaaaaaaaaaaaaaaaaaaaaaaaaaaaaaaaaaaaaaa1111,yummy,k5mc2zukm5hkbv2al9fcalp7v90tffv9yt26ya03ko5xh2fux0y6kbfxtru69bbw,rhkdhabl,,,02,,,,5901,2021-12-02 23: 44:51,13000,2005524,,,승언,,,01
317,1111111111111111111111111111111111111111111111111111111111111111111111111111111111111111,aaaaaaaaaaaaaaaaaaaaaaaaaaaaaaaaaaaaaaaaaaaaaaaaaaaaaaaaaaaa1111,yummy,vpntzehvs95z6rn1q2s8a1116sukip8c7g5bm23qdujfx9p9yro1yms5w6ozayqo,jbwbesja,,,02,,,,5901,2021-12-03 15: 58:41,50000,2055524,,,혜원,,,01
318,1111111111111111111111111111111111111111111111111111111111111111111111111111111111111111,aaaaaaaaaaaaaaaaaaaaaaaaaaaaaaaaaaaaaaaaaaaaaaaaaaaaaaaaaaaa1111,yummy,vpntzehvs95z6rn1q2s8a1116sukip8c7g5bm23qdujfx9p9yro1yms5w6ozayqo,jbwbesja,,,02,,,,5901,2021-12-06 11: 34:24,44544,2100068,,,혜원,,,01
319,1111111111111111111111111111111111111111111111111111111111111111111111111111111111111111,aaaaaaaaaaaaaaaaaaaaaaaaaaaaaaaaaaaaaaaaaaaaaaaaaaaaaaaaaaaa1111,yummy,db0vt0hrlblp90v94jcaknnu6p7zg71pc17ij91scjl78nodie69kt45fqmxuj4g,thrbpuku,,,02,,,,5202,2021-12-06 12: 46:20,16000,2084068,,,닉컴퍼니_최승언,,,01
320,1111111111111111111111111111111111111111111111111111111111111111111111111111111111111111,aaaaaaaaaaaaaaaaaaaaaaaaaaaaaaaaaaaaaaaaaaaaaaaaaaaaaaaaaaaa1111,yummy,cde73umdtxx2ch3i6xkutipatxgugcsx5mzzew8z8wfc1js0gnq6z1ywm2meji8a,qzptchfv,,,02,,,,5202,2021-12-06 20: 03:28,28000,2056068,,,이지똥,,,01
321,1111111111111111111111111111111111111111111111111111111111111111111111111111111111111111,aaaaaaaaaaaaaaaaaaaaaaaaaaaaaaaaaaaaaaaaaaaaaaaaaaaaaaaaaaaa1111,yummy,,,,,02,,,,5501,2021-12-09 13: 03:20,8000,2048068,,,로티세리 치킨외 1건,,C1,01
322,1111111111111111111111111111111111111111111111111111111111111111111111111111111111111111,aaaaaaaaaaaaaaaaaaaaaaaaaaaaaaaaaaaaaaaaaaaaaaaaaaaaaaaaaaaa1111,yummy,,,,,02,,,,5501,2021-12-15 11: 05:30,13700,2034368,,,카페 아메리카노 T 2잔+ 클라우드 치즈 케이크,,H1,01
323,1111111111111111111111111111111111111111111111111111111111111111111111111111111111111111,aaaaaaaaaaaaaaaaaaaaaaaaaaaaaaaaaaaaaaaaaaaaaaaaaaaaaaaaaaaa1111,yummy,p8yks3iy0ec56ggpfhttm4ceitq8zwp21i7b2w10vsegqdkp4m8o5il9pqipxzts,xyhtffkm,,,02,,,,5201,2021-12-16 10: 48:40,33500,2000868,국민,110-63-123456,***2701 구*,,,01
324,1111111111111111111111111111111111111111111111111111111111111111111111111111111111111111,aaaaaaaaaaaaaaaaaaaaaaaaaaaaaaaaaaaaaaaaaaaaaaaaaaaaaaaaaaaa1111,yummy,8wvmeg589acp0jdf9xyn6xq9j3xv06751b50f2hxae9nfi4wqofk9u2g9u3u1xq4,cymeoflb,,,02,,,,5901,2021-12-17 13: 37:48,22000,2022868,,,김서원,,,01
325,1111111111111111111111111111111111111111111111111111111111111111111111111111111111111111,aaaaaaaaaaaaaaaaaaaaaaaaaaaaaaaaaaaaaaaaaaaaaaaaaaaaaaaaaaaa1111,yummy,,,,,02,,,,5501,2021-12-17 16: 00:50,17000,2005868,,,황금올리브치킨+코카- 콜라1.25L,,I1,01
326,1111111111111111111111111111111111111111111111111111111111111111111111111111111111111111,aaaaaaaaaaaaaaaaaaaaaaaaaaaaaaaaaaaaaaaaaaaaaaaaaaaaaaaaaaaa1111,yummy,,,신한,110-63-123456,02,,2000000.0,30000.0,5102,2021-12-20 08: 49:30,30000,2035868,,,***6391 염*진,,,01
327,1111111111111111111111111111111111111111111111111111111111111111111111111111111111111111,aaaaaaaaaaaaaaaaaaaaaaaaaaaaaaaaaaaaaaaaaaaaaaaaaaaaaaaaaaaa1111,yummy,cpiumav6cf5mxnyjlw4k9wu600iqofjo1t4j9jlponzwu0456h18j3tz3sz5vczb,culngspy,,,02,,,,5202,2021-12-20 08: 49:30,48500,1987368,,,규댕댕,,,01
328,1111111111111111111111111111111111111111111111111111111111111111111111111111111111111111,aaaaaaaaaaaaaaaaaaaaaaaaaaaaaaaaaaaaaaaaaaaaaaaaaaaaaaaaaaaa1111,yummy,,,신한,110-63-123456,02,,2000000.0,40000.0,5102,2021-12-20 09: 46:56,40000,2027368,,,***6391 염*진,,,01
329,1111111111111111111111111111111111111111111111111111111111111111111111111111111111111111,aaaaaaaaaaaaaaaaaaaaaaaaaaaaaaaaaaaaaaaaaaaaaaaaaaaaaaaaaaaa1111,yummy,14dai49meyzde9cuun62b7db5dd9800b74p0acoysgd4o5wqrkrfx9d1efk2m996,mhqwtwtb,,,02,,,,5202,2021-12-20 09: 46:56,39125,1988243,,,매미년,,,01
330,1111111111111111111111111111111111111111111111111111111111111111111111111111111111111111,aaaaaaaaaaaaaaaaaaaaaaaaaaaaaaaaaaaaaaaaaaaaaaaaaaaaaaaaaaaa1111,yummy,,,신한,110-63-123456,02,,2000000.0,10000.0,5102,2021-12-20 10: 18:09,10000,1998243,,,***6391 염*진,,,01
331,1111111111111111111111111111111111111111111111111111111111111111111111111111111111111111,aaaaaaaaaaaaaaaaaaaaaaaaaaaaaaaaaaaaaaaaaaaaaaaaaaaaaaaaaaaa1111,yummy,4bkn3xfcs6zfpqj5xi9y3jdklkr4574ycews938u8wq8086z6azw312qiq86wv65,xgnbocjr,,,02,,,,5202,2021-12-20 10: 18:09,11055,1987188,,,멍청띨공이#,,,01
332,1111111111111111111111111111111111111111111111111111111111111111111111111111111111111111,aaaaaaaaaaaaaaaaaaaaaaaaaaaaaaaaaaaaaaaaaaaaaaaaaaaaaaaaaaaa1111,yummy,,,신한,110-63-123456,02,,2000000.0,20000.0,5102,2021-12-20 11: 33:38,20000,2007188,,,***6391 염*진,,,01
333,1111111111111111111111111111111111111111111111111111111111111111111111111111111111111111,aaaaaaaaaaaaaaaaaaaaaaaaaaaaaaaaaaaaaaaaaaaaaaaaaaaaaaaaaaaa1111,yummy,xhdmss6aeujx322bnugpy22gqx4ak7voruuzxtij0zid3s86svrvlvg5d7j9vs7l,unvktxbo,,,02,,,,5202,2021-12-20 11: 33:38,24925,1982263,,,멍청오지치즈#,,,01
334,1111111111111111111111111111111111111111111111111111111111111111111111111111111111111111,aaaaaaaaaaaaaaaaaaaaaaaaaaaaaaaaaaaaaaaaaaaaaaaaaaaaaaaaaaaa1111,yummy,,,신한,110-63-123456,02,,2000000.0,20000.0,5102,2021-12-20 12: 29:20,20000,2002263,,,***6391 염*진,,,01
335,1111111111111111111111111111111111111111111111111111111111111111111111111111111111111111,aaaaaaaaaaaaaaaaaaaaaaaaaaaaaaaaaaaaaaaaaaaaaaaaaaaaaaaaaaaa1111,yummy,db0vt0hrlblp90v94jcaknnu6p7zg71pc17ij91scjl78nodie69kt45fqmxuj4g,thrbpuku,,,02,,,,5202,2021-12-20 12: 29:20,15000,1987263,,,닉컴퍼니_최승언,,,01
336,1111111111111111111111111111111111111111111111111111111111111111111111111111111111111111,aaaaaaaaaaaaaaaaaaaaaaaaaaaaaaaaaaaaaaaaaaaaaaaaaaaaaaaaaaaa1111,yummy,db0vt0hrlblp90v94jcaknnu6p7zg71pc17ij91scjl78nodie69kt45fqmxuj4g,thrbpuku,,,02,,,,5202,2021-12-20 12: 33:12,1500,1985763,,,닉컴퍼니_최승언,,,01
337,1111111111111111111111111111111111111111111111111111111111111111111111111111111111111111,aaaaaaaaaaaaaaaaaaaaaaaaaaaaaaaaaaaaaaaaaaaaaaaaaaaaaaaaaaaa1111,yummy,,,신한,110-63-123456,02,,2000000.0,10000.0,5102,2021-12-21 12: 36:58,10000,1995763,,,***6391 염*진,,,01
338,1111111111111111111111111111111111111111111111111111111111111111111111111111111111111111,aaaaaaaaaaaaaaaaaaaaaaaaaaaaaaaaaaaaaaaaaaaaaaaaaaaaaaaaaaaa1111,yummy,db0vt0hrlblp90v94jcaknnu6p7zg71pc17ij91scjl78nodie69kt45fqmxuj4g,thrbpuku,,,02,,,,5202,2021-12-21 12: 36:58,11000,1984763,,,닉컴퍼니_최승언,,,01
339,1111111111111111111111111111111111111111111111111111111111111111111111111111111111111111,aaaaaaaaaaaaaaaaaaaaaaaaaaaaaaaaaaaaaaaaaaaaaaaaaaaaaaaaaaaa1111,yummy,vpntzehvs95z6rn1q2s8a1116sukip8c7g5bm23qdujfx9p9yro1yms5w6ozayqo,jbwbesja,,,02,,,,5901,2021-12-23 10: 49:14,12900,1997663,,,혜원,,,01
340,1111111111111111111111111111111111111111111111111111111111111111111111111111111111111111,aaaaaaaaaaaaaaaaaaaaaaaaaaaaaaaaaaaaaaaaaaaaaaaaaaaaaaaaaaaa1111,yummy,,,신한,110-63-123456,02,,2000000.0,20000.0,5102,2021-12-23 20: 38:38,20000,2017663,,,***6391 염*진,,,01
341,1111111111111111111111111111111111111111111111111111111111111111111111111111111111111111,aaaaaaaaaaaaaaaaaaaaaaaaaaaaaaaaaaaaaaaaaaaaaaaaaaaaaaaaaaaa1111,yummy,2vsmr89y2y824xff789tuy1nugyqhsxs32wbwsn1vcthec9n2elgpa188bvzfxs1,gtmvbnib,,,02,,,,5201,2021-12-23 20: 38:38,30000,1987663,"IBK
기업",110-63-123456,***6488 김*지,,,01
342,1111111111111111111111111111111111111111111111111111111111111111111111111111111111111111,aaaaaaaaaaaaaaaaaaaaaaaaaaaaaaaaaaaaaaaaaaaaaaaaaaaaaaaaaaaa1111,yummy,,,신한,110-63-123456,02,,2000000.0,20000.0,5102,2021-12-27 19: 36:08,20000,2007663,,,***6391 염*진,,,01
343,1111111111111111111111111111111111111111111111111111111111111111111111111111111111111111,aaaaaaaaaaaaaaaaaaaaaaaaaaaaaaaaaaaaaaaaaaaaaaaaaaaaaaaaaaaa1111,yummy,25f5r81mw6wkrgz70uta3mujshlrnk0ya80dh48rmojezw17x108cvbemze5afz6,mteuompl,,,02,,,,5202,2021-12-27 19: 36:08,20000,1987663,,,박현곤오빠,,,01
344,1111111111111111111111111111111111111111111111111111111111111111111111111111111111111111,aaaaaaaaaaaaaaaaaaaaaaaaaaaaaaaaaaaaaaaaaaaaaaaaaaaaaaaaaaaa1111,yummy,,,신한,110-63-123456,02,,2000000.0,10000.0,5102,2021-12-28 21: 03:31,10000,1997663,,,***6391 염*진,,,01
345,1111111111111111111111111111111111111111111111111111111111111111111111111111111111111111,aaaaaaaaaaaaaaaaaaaaaaaaaaaaaaaaaaaaaaaaaaaaaaaaaaaaaaaaaaaa1111,yummy,cde73umdtxx2ch3i6xkutipatxgugcsx5mzzew8z8wfc1js0gnq6z1ywm2meji8a,qzptchfv,,,02,,,,5202,2021-12-28 21: 03:31,12000,1985663,,,이지똥,,,01
346,1111111111111111111111111111111111111111111111111111111111111111111111111111111111111111,aaaaaaaaaaaaaaaaaaaaaaaaaaaaaaaaaaaaaaaaaaaaaaaaaaaaaaaaaaaa1111,yummy,,,,,02,,,,5501,2021-12-29 15:02,3200,1982463,,,싱글레귤러 아이스크림,,Z1,01
347,1111111111111111111111111111111111111111111111111111111111111111111111111111111111111111,aaaaaaaaaaaaaaaaaaaaaaaaaaaaaaaaaaaaaaaaaaaaaaaaaaaaaaaaaaaa1111,yummy,cde73umdtxx2ch3i6xkutipatxgugcsx5mzzew8z8wfc1js0gnq6z1ywm2meji8a,qzptchfv,,,02,,,,5202,2021-11-11,12000,1985663,,,이지똥,,,01
